dốc, đường dốc, độ dốc; nghiêng, dốc	slope
chậm, chậm chạp	slow
một cách chậm chạp, chậm dần	slowly
nhỏ, bé	small
mạnh, ác liệt	smart
đập, vỡ tan thành mảnh; sự đập, vỡ tàn thành mảnh	smash
ngửi; sự ngửi, khứu giác	smell
cười, mỉm cười; nụ cười, vẻ tươi cười	smile
khói, hơi thuốc; hút thuốc, bốc khói, hơi	smoke
sự hút thuốc	smoking
nhẵn, trơn, mượt mà	smooth
một cách êm ả, trôi chảy	smoothly
con rắn; người nham hiểm, xảo trá	snake
tuyết; tuyết rơi	snow
như vậy, như thế; vì thế, vì vậy, vì thế cho nên	so
xà phòng	soap
có tính xã hội	social
có tính xã hội	socially
xã hội	society
tất ngăns, miếng lót giày	sock
mềm, dẻo	soft
một cách mềm dẻo	softly
phần mềm (m.tính)	software
đất trồng; vết bẩn	soil
lính, quân nhân	soldier
rắn; thể rắn, chất rắnh	solid
sự giải quyết, giải pháp	solution
giải, giải thích, giải quyết	solve
or /səm/ một it, một vài	some
người nào đó	somebody
không biết làm sao, bằng cách này hay cách khác	somehow
một điều gì đó, một việc gì đó, một cái gì đó	something
thỉnh thoảng, đôi khi	sometimes
đến mức độ nào đó, hơi, một chút	somewhat
nơi nào đó. đâu đó	somewhere
con trai	son
bài hát	song
sớm, chẳng bao lâu nữa	soon
đau, nhức	sore
xin lỗi, lấy làm tiếc, lấy làm buồn	sorry
thứ, hạng loại; lựa chọn, sắp xếp, phân loại	sort
tâm hồn, tâm trí, linh hồn	soul
âm thanh; nghe	sound
xúp, canh, cháo	soup
chua, có vị giấm	sour
nguồn	source
phương Nam, hướng Nam; ở phía Nam; hướng về phía Nam	south
thuộc phương Nam	southern
