vị, mùi; cho gia vị, làm tăng thêm mùi vị	flavour
thịt	flesh
sự bỏ chạy, rút chạy; sự bay, chuyến bay	flight
nổi, trôi, lơ lửng	float
lụt, lũ lụtl; tràn đầy, tràn ngập	flood
sàn, tầng (nhà)	floor
bột, bột mỳ	flour
sự chảy; chảy	flow
hoa, bông, đóa, cây hoa	flower
bệnh cúm	flu
bay; sự bay, quãng đường bay	fly
biết bay; sự bay, chuyến bay	flying
tập trung; trung tâm, trọng tâm (n.bóng)	focus
gấp, vén, xắn; nếp gấp	fold
gấp lại được	folding
đi theo sau, theo, tiếp theo	follow
tiếp theo, theo sau, sau đây; sau, tiếp theo	following
đồ ăn, thức, món ăn	food
chân, bàn chân	foot
bóng đá	football
cho, dành cho...	for
sức mạnh; ép buộc, cưỡng ép	force
sự dự đoán, dự báo; dự đoán, dự báo	forecast
(thuộc) nước ngoài, từ nước ngoài, ở nước ngoài	foreign
rừng	forest
mãi mãi	forever
quên	forget
tha, tha thứ	forgive
cái nĩa	fork
hình thể, hình dạng, hình thức; làm thành, được tạo thành	form
hình thức	formal
chính thức	formally
trước, cũ, xưa, nguyên	former
trước đây, thuở xưa	formerly
công thức, thể thức, cách thức	formula
sự giàu có, sự thịnh vượng	fortune
về tương lai, sau này ở phía trước, tiến về phía trước	forward
ở phía trước, tiến về phía trước	forward
(q.k of find) tìm, tìm thấy	found
sự thành lập, sự sáng lập; tổ chức	foundation
cấu trúc, hệ thống; dàn xếp, bố trí	frame
miễn phí, tự do, giải phóng, trả tự do	free
tự do, thoải mái	freely
sự tự do; nền tự do	freedom
đóng băng, đông lạnh	freeze
lạnh giá	frozen
thường xuyên	frequent
thường xuyên	frequently
tươi, tươi tắn	fresh
tươi mát, khỏe khoắn	freshly
