sự giơ, duỗi; sự kéo dài, sự dành cho, gửi lời	extension
rộng rãi, bao quát	extensive
quy mô, phạm vi	extent
thêm, phụ, ngoại; thứ thêm, phụ	extra
đặc biệt, lạ thường, khác thường	extraordinary
vô cùng, khắc nghiệt, quá khích, cực đoan; sự quá khích	extreme
vô cùng, cực độ	extremely
mắt	eye
mặt, thể diện; đương đầu, đối phó, đối mặt	face
điều kiện dễ dàng, sự dễ dàng, thuận lợi	facility
việc, sự việc, sự kiện	fact
nhân tố	factor
nhà máy, xí nghiệp, xưởng	factory
sai, thất bại	fail
sự thất bại, người thất bại	failure
nhút nhát, yếu ớt	faint
nhút nhát, yếu ớt	faintly
hợp lý, công bằng; thuận lợi	fair
hợp lý, công bằng	fairly
gian lận, không công bằng; bất lợi	unfair
gian lận, không công bằng; bất lợi	unfairly
sự tin tưởng, tin cậy; niềm tin, vật đảm bảo	faith
trung thành, chung thủy, trung thực	faithful
trung thành, chung thủy, trung thực	faithfully
rơi, ngã, sự rơi, ngã	fall
sai, nhầm, giả dối	false
tên tuổi, danh tiếng	fame
thân thiết, quen thộc	familiar
gia đình, thuộc gia đình	family
nổi tiếng	famous
người hâm mộ	fan
tưởng tượng, cho, nghĩ rằng; tưởng tượng	fancy
xa	far
xa hơn nữa; thêm nữa	further
trang trại	farm
công việc trồng trọt, đồng áng	farming
nông dân, người chủ trại	farmer
mốt, thời trang	fashion
đúng mốt, hợp thời trang	fashionable
nhanh	fast
buộc, trói	fasten
béo, béo bở; mỡ, chất béo	fat
cha (bố)	father
vòi (ở thùng rượu....)	faucet
sự thiết sót, sai sót	fault
thiện ý, sự quý mến; sự đồng ý; sự chiếu cố	favour
favor (of) ủng hộ cái gì (to be in favour of something )	in
được ưa thích; người (vật) được ưa thích	favourite
