sự chúc mừng, khen ngợi; lời chúc mừng, khen ngợi (s)	congratulations
đại hội, hội nghị, Quốc hội	congress
kết nối, nối	connect
sự kết nối, sự giao kết	connection
tỉnh táo, có ý thức, biết rõ	conscious
bất tỉnh, không có ý thức, không biết rõ	unconscious
kết quả, hậu quả	consequence
thận trọng, dè dặt, bảo thủ	conservative
cân nhắc, xem xét; để ý, quan tâm, lưu ý đến	consider
lớn lao, to tát, đáng kể	considerable
đáng kể, lớn lao, nhiều	considerably
sự cân nhắc, sự xem xét, sự để ý, sự quan tâm	consideration
gồm có	consist
kiên trì, bền lòng	constant
kiên định	constantly
xây dựng	construct
sự xây dựng	construction
tra cứu, tham khảo, thăm dò, hỏi ý kiến	consult
người tiêu dùng	consumer
sự liên lạc, sự giao thiệp; tiếp xúc	contact
bao hàm, chứa đựng, bao gồm	contain
cái đựng, chứa; công te nơ	container
đương thời, đương đại	contemporary
nội dung, sự hài lòng	content
cuộc thi, trận đấu, cuộc tranh luận, cuộc chiến đấu, chiến tranh	contest
văn cảnh, khung cảnh, phạm vi	context
lục địa, đại lục (lục địa Bắc Mỹ)	continent
tiếp tục, làm tiếp	continue
liên tục, liên tiếp	continuous
liên tục, liên tiếp	continuously
hợp đồng, sự ký hợp đồng; ký kết	contract
or /'kɔntræst / sự tương phản; làm tương phản, làm trái ngược	contrast
tương phản	contrasting
đóng góp, ghóp phần	contribute
sự đóng góp, sự góp phần	contribution
sự điều khiển, quyền hành, quyền lực, quyền chỉ huy	control
được điều khiển, được kiểm tra	controlled
không bị điều khiển, không bị kiểm tra, không bị hạn chế	uncontrolled
tiện lợi, thuận lợi, thích hợp	convenient
hội nghị, hiệp định, quy ước	convention
quy ước	conventional
cuộc đàm thoại, cuộc trò chuyện	conversation
đổi, biến đổi	convert
làm cho tin, thuyết phục; làm cho nhận thức thấy	convince
nấu ăn, người nấu ăn	cook
sự nấu ăn, cách nấu ăn	cooking
lò, bếp, nồi nấu	cooker
bánh quy	cookie
