mát mẻ, điềm tĩnh; làm mát,	cool
đối phó, đương đầu	cope
bản sao, bản chép lại; sự sao chép; sao chép, bắt chước	copy
nòng cốt, hạt nhân; đáy lòng	core
góc (tường, nhà, phố...)	corner
đúng, chính xác; sửa, sửa chữa	correct
đúng, chính xác	correctly
giá, chi phí; trả giá, phải trả	cost
nhà tranh	cottage
bông, chỉ, sợi	cotton
ho, sự ho, tiếng hoa	cough
ho	coughing
có thể, có khả năng	could
hội đồng	council
đếm, tính	count
quầy hàng, quầy thu tiền, máy đếm	counter
nước, quốc gia, đất nước	country
miền quê, miền nông thôn	countryside
hạt, tỉnh	county
đôi, cặp; đôi vợ chồng, cặp nam nữ	couple
sự can đảm, sự dũng cảm, dũng khí	courage
tiến trình, quá trình diễn tiến; sân chạy đua	course
sân, sân (tennis...), tòa án, quan tòa, phiên tòa	court
anh em họ	cousin
bao bọc, che phủ; vỏ, vỏ bọc	cover
có mái che, kín đáo	covered
sự bao bọc, sự che phủ, cái bao, bọc	covering
con bò cái	cow
cừ, xuất sắc; làm nứt, làm vỡ, nứt nẻ, rạn nứt	crack
rạn, nứt	cracked
nghề, nghề thủ công	craft
vải thô; sự rơi (máy bay), sự phá sản, sụp đổ; phá tan tành, phá vụn	crash
điên, mất trí	crazy
kem	cream
sáng tạo, tạo nên	create
sinh vật, loài vật	creature
sự tin, lòng tin, danh tiếng; tiền gửi ngân hàng	credit
thẻ tín dụng	credit
tội, tội ác, tội phạm	crime
có tội, phạm tội; kẻ phạm tội, tội phạm	criminal
sự khủng hoảng, cơn khủng hoảng	crisis
giòn	crisp
tiêu chuẩn	criterion
phê bình, phê phán; khó tính	critical
sự phê bình, sự phê phán, lời phê bình, lời phê phán	criticism
phê bình, phê phán, chỉ trích	criticize
vụ mùa	crop
cây Thánh Giá, nỗi thống khổ; sự băng qua; băng qua, vượt qua	cross
