điểm số, bản thắng, tỷ số; đạt được, thành công, cho điểm	score
cào, làm xước da; sự cào, sự trầy xước da	scratch
gào thét, kêu lên; tiếng thét, tiếng kêu to	scream
màn che, màn ảnh, màn hình; phim ảnh nói chung	screen
đinh vít, đinh ốc; bắt vít, bắt ốc	screw
biển	sea
hải cẩu; săn hải cẩu	seal
sự tìm kiếm, sự thăm dò, sự điều tra; tìm kiếm, thăm dò, điều tra	search
mùa	season
ghế, chỗ ngồi	seat
thứ hai, ở vị trí thứ 2, thứ nhì; người về nhì	second
trung học, thứ yếu	secondary
bí mật; điều bí mật	secret
bí mật, riêng tư	secretly
thư ký	secretary
mục, phần	section
khu vực, lĩnh vực	sector
chắc chắn, đảm bảo; bảo đảm, giữ an ninh	secure
sự an toàn, sự an ninh	security
nhìn, nhìn thấy, quan sát	see
hạt, hạt giống	seed
tìm, tìm kiếm, theo đuổi	seek
có vẻ như, dường như	seem
chọn lựa, chọn lọc	select
sự lựa chọn, sự chọc lọc	selection
bản thân mình	self
bán	sell
thượng nghi viện, ban giám hiệu	senate
thượng nghị sĩ	senator
gửi, phái đi	send
nhiều tuổi hơn, dành cho trẻ em trên 11t; người lớn tuổi hơn, sinh viên năm cuối trường trung học, cao đẳng	senior
giác quan, tri giác, cảm giác	sense
có óc xét đoán; hiểu, nhận biết được	sensible
dễ bị thương, dễ bị hỏng; dễ bị xúc phạm	sensitive
câu	sentence
khác nhau, riêng biệt; làm rời, tách ra, chia tay	separate
ly thân	separated
không cùng nhau, thành người riêng, vật riêng	separately
sự chia cắt, phân ly, sự chia tay, ly thân	separation
tháng 9	September
loạt, dãy, chuỗi	series
đứng đắn, nghiêm trang	serious
đứng đắn, nghiêm trang	seriously
người hầu, đầy tớ	servant
phục vụ, phụng sự	serve
sự phục vụ, sự hầu hạ	service
buổi họp, phiên họp, buổi, phiên	session
bộ, bọn, đám, lũ; đặt để, bố trí	set
giải quyết, dàn xếp, hòa giải, đặt, bố trí	settle
