vi	en
bỏ, từ bỏ	abandon
bị bỏ rơi, bị ruồng bỏ	abandoned
khả năng, năng lực	ability
có năng lực, có tài	able
không có năng lực, không có tài	unable
khoảng, về	about
ở trên, lên trên	above
ở, ra nước ngoài, ngoài trời	abroad
sự vắng mặt	absence
vắng mặt, nghỉ	absent
tuyệt đối, hoàn toàn	absolute
tuyệt đối, hoàn toàn	absolutely
thu hút, hấp thu, lôi cuốn	absorb
lộng hành, lạm dụng	abuse
thuộc học viện, ĐH, viện hàn lâm	academic
trọng âm, dấu trọng âm	accent
chấp nhận, chấp thuận	accept
có thể chấp nhận, chấp thuận	acceptable
	unacceptable
lối, cửa, đường vào	access
tai nạn, rủi ro	accident
tình cờ, bất ngờ	accidental
tình cờ, ngẫu nhiên	accidentally
sự thích nghi, điều tiết	accommodation
đi theo, đi cùng, kèm theo	accompany
theo, y theo	according
tài khoản, kế toán; tính toán, tính đến	account
đúng đắn, chính xác, xác đáng	accurate
đúng đắn, chính xác	accurately
tố cáo, buộc tội, kết tội	accuse
đạt được, dành được	achieve
thành tích, thành tựu	achievement
axit	acid
công nhận, thừa nhận	acknowledge
dành được, đạt được, kiếm được	acquire
qua, ngang qua	across
hành động, hành vi, cử chỉ, đối xử	act
hành động, hành vi, tác động	action
tích cực hoạt động, nhanh nhẹn	active
	actively
	activity
/'æktris/ diễn viên	actor,
thực tế, có thật	actual
hiện nay, hiện tại	actually
quảng cáo	advertisement
tra, lắp vào	adapt
cộng, thêm vào	add
tính cộng, phép cộng	addition
thêm vào, tăng thêm	additional
địa chỉ, đề địa chỉ	address
đầy, đầy đủ	adequate
tương xứng, thỏa đáng	adequately
sửa lại cho đúng, điều chỉnh	adjust
sự khâm phục,người kp, thán phục	admiration
khâm phục, thán phục	admire
nhận vào, cho vào, kết hợp	admit
nhận làm con nuôi, bố mẹ nuôi	adopt
người lớn, người trưởng thành; trưởng thành	adult
sự tiến bộ, tiến lên; đưa lên, đề xuất	advance
tiên tiến, tiến bộ, cấp cao	advanced
sự thuận lợi, lợi ích, lợi thế	advantage
sự phiêu lưu, mạo hiểm	adventure
báo cho biết, báo cho biết trước	advertise
sự quảng cáo, nghề quảng cáo	advertising
	advertisement
lời khuyên, lời chỉ bảo	advice
khuyên, khuyên bảo, răn bảo	advise
việc	affair
làm ảnh hưởng, tác động đến	affect
	affection
có thể, có đủ khả năng, điều kiện (làm gì)	afford
sợ, sợ hãi, hoảng sợ	afraid
sau, đằng sau, sau khi	after
buổi chiều	afternoon
sau này, về sau, rồi thì, sau đấy	afterwards
lại, nữa, lần nữa	again
chống lại, phản đối	against
tuổi	age
già đi (v)	aged
tác dụng, lực; môi giới, trung gian	agency
đại lý, tác nhân	agent
xâm lược, hung hăng (US: xông xáo)	aggressive
trước đây	ago
đồng ý, tán thành	agree
sự đồng ý, tán thành; hiệp định, hợp đồng	agreement
trước, về phía trước	ahead
sự giúp đỡ; thêm vào, phụ vào	aid
sự nhắm (bắn), mục tiêu, ý định; nhắm, tập trung, hướng vào	aim
không khí, bầu không khí, không gian	air
máy bay, khí cầu	aircraft
sân bay, phi trường	airport
báo động, báo nguy	alarm
làm lo sợ, làm hốt hoảng, làm sợ hãi	alarming
	alarmed
rượu cồn	alcohol
rượu; người nghiện rượu	alcoholic
sống, vẫn còn sống, còn tồn tại	alive
tất cả	all
cho phép, để cho	allow
tốt, ổn, khỏe mạnh; được	all
nước đồng minh, liên minh; liên kết, lien minh, kết thông gia	ally
lien minh, đồng minh, thông gia	allied
hầu như, gần như	almost
cô đơn, một mình	alone
dọc theo, theo; theo chiều dài, suốt theo	along
sát cạnh, kế bên, dọc theo	alongside
lớn tiếng, to tiếng	aloud
bảng chữ cái, bước đầu, điều cơ bản	alphabet
thuộc bảng chứ cái	alphabetical
theo thứ tự abc	alphabetically
đã, rồi, đã… rồi	already
cũng, cũng vậy, cũng thế	also
thay đổi, biến đổi, sửa đổi	alter
sự lựa chọn; lựa chọn	alternative
như một sự lựa chọn	alternatively
mặc dù, dẫu cho	although
hoàn toàn, hầu như; nói chung	altogether
luôn luôn	always
làm ngạc nhiên, làm sửng sốt	amaze
kinh ngạc, sửng sốt	amazing
kinh ngạc, sửng sốt	amazed
hoài bão, khát vọng	ambition
xe cứu thương, xe cấp cứu	ambulance
giữa, ở giữa	among
số lượng, số nhiều; lên tới (money)	amount
làm cho vui, thích, làm buồn cười	amuse
vui thích	amusing
vui thích	amused
phân tích	analyse
sự phân tích	analysis
xưa, cổ	ancient
và	and
sự tức giận, sự giận dữ	anger
góc	angle
giận, tức giận	angry
tức giận, giận dữ	angrily
động vật, thú vật	animal
mắt cá chân	ankle
ngày, lễ kỉ niệm	anniversary
báo, thông báo	announce
chọc tức, làm bực mình; làm phiền, quẫy nhiễu	annoy
chọc tức, làm bực mình; làm phiền, quẫy nhiễu	annoying
bị khó chịu, bực mình, bị quấy rầy	annoyed
hàng năm, từng năm	annual
hàng năm, từng năm	annually
khác	another
sự trả lời; trả lời	answer
thấy trước, chặn trước, lường trước	anticipate
mối lo âu, sự lo lắng	anxiety
lo âu, lo lắng, băn khoăn	anxious
lo âu, lo lắng, băn khoăn	anxiously
một người, vật nào đó; bất cứ; một chút nào, tí nào	any
người nào, bất cứ ai	anyone
việc gì, vật gì; bất cứ việc gì, vật gì	anything
thế nào cũng được, dù sao chăng nữa	anyway
bất cứ chỗ nào, bất cứ nơi đâu	anywhere
về một bên, qua một bên	apart
ngoài…ra	apart
căn phòng, căn buồng	apartment
xin lỗi, tạ lỗi	apologize
rõ ràng, rành mạch; bề ngoài, có vẻ	apparent
nhìn bên ngoài, hình như	apparently
sự kêu gọi, lời kêu gọi; kêu gọi, cầu khẩn	appeal
xuất hiện, hiện ra, trình diện	appear
sự xuất hiện, sự trình diện	appearance
quả táo	apple
sự gắn vào, vật gắn vào; sự chuyên cần, chuyên tâm	application
gắn vào, ghép vào, áp dụng vào	apply
bổ nhiệm, chỉ định, chọn	appoint
sự bổ nhiệm, người được bổ nhiệm	appointment
thấy rõ; nhận thức	appreciate
đến gần, lại gần; sự đến gần, sự lại gần	approach
thích hợp, thích đáng	appropriate
sự tán thành, đồng ý, sự chấp thuận	approval
tán thành, đồng ý, chấp thuận	approve
tán thành, đồng ý, chấp thuận	approving
giống với, giống hệt với	approximate
khoảng chừng, độ chừng	approximately
tháng Tư	April
diện tích, bề mặt	area
chứng tỏ, chỉ rõ	argue
lý lẽ	argument
xuất hiện, nảy ra, nảy sinh ra	arise
cánh tay; vũ trang, trang bị (vũ khí)	arm
vũ khí, binh giới, binh khí	arms
vũ trang	armed
quân đội	army
xung quanh, vòng quanh	around
sắp xếp, sắp đặt, sửa soạn	arrange
sự sắp xếp, sắp đặt, sự sửa soạn	arrangement
bắt giữ, sự bắt giữ	arrest
sự đến, sự tới nơi	arrival
đến, tới nơi	arrive
tên, mũi tên	arrow
nghệ thuật, mỹ thuật	art
bài báo, đề mục	article
nhân tạo	artificial
nhân tạo	artificially
nghệ sĩ	artist
thuộc nghệ thuật, thuộc mỹ thuật	artistic
như (as you know…)	as
ngượng, xấu hổ	ashamed
về một bên, sang một bên	aside
ngoài… ra	apart
hỏi	ask
ngủ, đang ngủ	asleep
vẻ bề ngoài, diện mạo	aspect
giúp, giúp đỡ; tham dự, có mặt	assist
sự giúp đỡ	assistance
người giúp đỡ, người phụ tá; giúp đỡ, phụ tá	assistant
kết giao, liên kết, kết hợp, cho cộng tác	associate
sự kết hợp, sự liên kết	association
mang, khoác, có, lấy (cái vẻ, tính chất…)	assume
đảm bảo, cam đoan	assure
khí quyển	atmosphere
nguyên tử	atom
gắn, dán, trói, buộc	attach
gắn bó	attached
sự tấn công, sự công kích; tấn công, công kích	attack
sự cố gắng, sự thử; cố gắng, thử	attempt
cố gắng, thử	attempted
dự, có mặt	attend
sự chú ý	attention
thái độ, quan điểm	attitude
người được ủy quyền	attorney
hút; thu hút, hấp dẫn	attract
sự hút, sức hút	attraction
hút, thu hút, có duyên, lôi cuốn	attractive
thính, khan giả	audience
tháng Tám	August
cô, dì	aunt
tác giả	author
uy quyền, quyền lực	authority
tự động	automatic
một cách tự động	automatically
mùa thu (US: mùa thu là fall)	autumn
có thể dùng được, có giá trị, hiệu lực	available
trung bình, số trung bình, mức trung bình	average
tránh, tránh xa	avoid
đánh thức, làm thức dậy	awake
phần thưởng; tặng, thưởng	award
biết, nhận thức, nhận thức thấy	aware
xa, xa cách, rời xa, đi xa	away
oai nghiêm, dễ sợ	awful
tàn khốc, khủng khiếp	awfully
vụng về, lung túng	awkward
vụng về, lung túng	awkwardly
lưng, về phía sau, trở lại	back
phía sau; nền	background
	backwards
về phía sau, lùi lại	backward
vi khuẩn	bacteria
xấu, tồi	bad
xấu, tồi	badly
xấu tính, dễ nổi cáu	bad-tempered
bao, túi, cặp xách	bag
hành lý	baggage
nung, nướng bằng lò	bake
cái cân; làm cho cân bằng, tương xứng	balance
quả bóng	ball
cấm, cấm chỉ; sự cấm	ban
băng, đai, nẹp	band
dải băng; băng bó	bandage
bờ (sông…) , đê	bank
quán bán rượu	bar
sự mặc cả, sự giao kèo mua bán	bargain
đặt chướng ngại vật	barrier
cơ sở, cơ bản, nền móng; đặt tên, đặt cơ sở trên cái gì	base
cơ bản, cơ sở	basic
cơ bản, về cơ bản	basically
nền tảng, cơ sở	basis
sự tắm	bath
buồng tắm, nhà vệ sinh	bathroom
pin, ắc quy	battery
trận đánh, chiến thuật	battle
gian (nhà), nhịp (cầu), chuồng (ngựa); bays: vòng nguyệt quế	bay
bãi biển	beach
mỏ chim	beak
mang, cầm, vác, đeo, ôm	bear
râu	beard
tiếng đập, sự đập; đánh đập, đấm	beat
đẹp	beautiful
tốt đẹp, đáng hài lòng	beautifully
vẻ đẹp, cái đẹp; người đẹp	beauty
bởi vì, vì	because
vì, do bởi	because
trở thành, trở nên	become
cái giường	bed
phòng ngủ	bedroom
thịt bò	beef
rượu bia	beer
trước, đằng trước	before
bắt đầu, khởi đầu	begin
phần đầu, lúc bắt đầu, lúc khởi đầu	beginning
sự thay mặt	behalf
đối xử, ăn ở, cư xử	behave
sau, ở đằng sau	behind
lòng tin, đức tin, sự tin tưởng	belief
tin, tin tưởng	believe
cái chuông, tiếng chuông	bell
thuộc về, của, thuộc quyền sở hữu	belong
ở dưới, dưới thấp, phía dưới	below
dây lưng, thắt lưng	belt
chỗ rẽ, chỗ uốn; khuỷu tay; cúi xuống, uốn cong	bend
khiếu, sở thích, khuynh hướng	bent
ở dưới, dưới thấp	beneath
lợi, lợi ích; giúp ích, làm lợi cho	benefit
bên cạnh, so với	beside
đánh cuộc, cá cược; sự đánh cuộc	bet
sự đánh cuộc	betting
/best/ tốt hơn, tốt nhất	better,
/wel/ tốt, khỏe	good,
giữa, ở giữa	between
ở xa, phía bên kia	beyond
xe đạp	bicycle
đặt giá, trả giá; sự đặt giá, sự trả giá	bid
to, lớn	big
hóa đơn, giấy bạc	bill
thùng, thùng đựng rượu	bin
sinh vật học	biology
chim	bird
sự ra đời, sự sinh đẻ	birth
ngày sinh, sinh nhật	birthday
bánh quy	biscuit
miếng, mảnh	bit
cắn, ngoạm; sự cắn, sự ngoạm	bite
đắng; đắng cay, chua xót	bitter
đắng, đắng cay, chua xót	bitterly
đen; màu đen	black
lưỡi (dao, kiếm); lá (cỏ, cây); mái (chèo); cánh (chong chóng)	blade
khiển trách, mắng trách; sự khiển trách, sự mắng trách	blame
trống, để trắng; sự trống rỗng	blank
ngây ra, không có thần	blankly
đui, mù	blind
khối, tảng (đá); làm ngăn cản, ngăn chặn	block
hoe vàng, mái tóc hoe vàng	blonde
máu, huyết; sự tàn sát, chem giết	blood
nở hoa; sự nở hoa	blow
xanh, màu xanh	blue
tấm ván; lát ván, lót ván	board
tàu, thuyền	boat
thân thể, thân xác	body
sôi, luộc	boil
quả bom; oánh bom, thả bom	bomb
xương	bone
sách; ghi chép	book
giày ống	boot
bờ, mép, vỉa, lề (đường)	border
buồn chán, buồn tẻ	bore
buồn chán	boring
buồn chán	bored
sinh, đẻ	born:
vay, mượn	borrow
ông chủ, thủ trưởng	boss
cả hai	both
làm phiền, quấy rầy, làm bực mình	bother
chai, lọ	bottle
phần dưới cùng, thấp nhất; cuối, cuối cùng	bottom
nhất định, chắc chắn	bound
cái bát	bowl
hộp, thùng	box
con trai, thiếu niên	boy
bạn trai	boyfriend
óc não; đầu óc, trí não	brain
ngành; nhành cây, nhánh song, ngả đường	branch
nhãn (hàng hóa)	brand
gan dạ, can đảm	brave
bánh mỳ	bread
bẻ gãy, đập vỡ; sự gãy, sự vỡ	break
bị gãy, bị vỡ	broken
bữa điểm tâm, bữa sáng	breakfast
ngực, vú	breast
hơi thở, hơi	breath
hít, thở	breathe
sự hô hấp, sự thở	breathing
nuôi dưỡng, chăm sóc, giáo dục; sinh đẻ; nòi giống	breed
gạch	brick
cái cầu	bridge
ngắn, gọn, vắn tắt	brief
ngắn, gọn, vắn tắt, tóm tắt	briefly
sáng, sáng chói	bright
sáng chói, tươi	brightly
tỏa sáng, rực rỡ, chói lọi	brilliant
mang, cầm , xách lại	bring
rộng	broad
rộng, rộng rãi	broadly
tung ra khắp nơi,truyền rộng rãi; phát thanh, quảng bá	broadcast
anh, em trai	brother
nâu, màu nâu	brown
bàn chải; chải, quét	brush
bong bóng, bọt, tăm	bubble
ngân sách	budget
xây dựng	build
sự xây dựng, công trình xây dựng; tòa nhà binđinh	building
đạn (súng trường, súng lục)	bullet
búi, chùm, bó, cụm, buồng; bầy, đàn (AME)	bunch
đốt, đốt cháy, thắp, nung, thiêu	burn
bị đốt, bị cháy, khê; rám nắng, sạm (da)	burnt
nổ, nổ tung (bom, đạn); nổ, vỡ (bong bóng); háo hức	burst
chôn cất, mai táng	bury
xe buýt	bus
bụi cây, bụi rậm	bush
việc buôn bán, thương mại, kinh doanh	business
thương nhân	businessman,
bận, bận rộn	busy
nhưng	but
bơ	butter
cái nút, cái khuy, cúc	button
mua	buy
người mua	buyer
bởi, bằng	by
tạm biệt	bye
đồng xu (bằng 1/100 đô la)	cent
tủ có nhiều ngăn đựng đồ	cabinet
dây cáp	cable
bánh ngọt	cake
tính toán	calculate
sự tính toán	calculation
gọi; tiếng kêu, tiếng gọi	call
yên lặng, làm dịu đi; sự yên lặng, sự êm ả	calm
yên lặng, êm ả; bình tĩnh, điềm tĩnh	calmly
máy ảnh	camera
trại, chỗ cắm trại; cắm trại, hạ trại	camp
sự cắm trại	camping
chiến dịch, cuộc vận động	campaign
có thể; nhà tù, nhà giam, bình, ca đựng	can
có thể	could
hủy bỏ, xóa bỏ	cancel
bệnh ung thư	cancer
người ứng cử, thí sinh, người dự thi	candidate
kẹo	candy
mũ lưỡi trai, mũ vải	cap
có tài, có năng lực; có khả năng, cả gan	capable
năng lực, khả năng tiếp thu, năng suất	capacity
thủ đô, tiền vốn; chủ yếu, chính yếu, cơ bản	capital
người cầm đầu, người chỉ huy, thủ lĩnh	captain
bắt giữ, bắt; sự bắt giữ, sự bị bắt	capture
xe hơi	car
thẻ, thiếp	card
bìa cứng, các tông	cardboard
sự chăm sóc, chăm nom; chăm sóc	care
nghề nghiệp, sự nghiệp	career
cẩn thận, cẩn trọng, biết giữ gìn	careful
cẩn thận, chu đáo	carefully
sơ suất, cầu thả	careless
cẩu thả, bất cẩn	carelessly
tấm thảm, thảm (cỏ)	carpet
củ cà rốt	carrot
mang, vác, khuân chở	carry
vỏ, ngăn, túi	case
tiền, tiền mặt	cash
quăng, ném, thả, đánh gục; sự quăng, sự ném (lưới), sự thả (neo)	cast
thành trì, thành quách	castle
con mèo	cat
bắt lấy, nắm lấy, tóm lấy, chộp lấy	catch
hạng, loại; phạm trù	category
nguyên nhân, nguyên do; gây ra, gây nên	cause
dừng, ngừng, ngớt, thôi, hết, tạnh	cease
trần nhà	ceiling
kỷ niệm, làm lễ kỷ niệm; tán dương, ca tụng	celebrate
sự kỷ niệm, lễ kỷ niệm; sự tán dương, sự ca tụng	celebration
ô, ngăn	cell
(especially NAmE) điện thoại di động	cellphone
đồng xu (=1/100 đô la)	cent
(abbr. cm) xen ti met	centimetre
trung tâm, ở giữa, trung ương	central
điểm giữa, trung tâm, trung ương	centre
thế kỷ	century
nghi thức, nghi lễ	ceremony
chắc chắn	certain
chắc chắn, nhất định	certainly
thiếu chính xác, không chắc chắn	uncertain
giấy chứng nhận, bằng, chứng chỉ	certificate
dây, xích; xính lại, trói lại	chain
ghế	chair
/'tʃeə,wumən/ chủ tịch, chủ tọa	chairman,
sự thử thách, sự thách thức; thách thức, thử thách	challenge
buồng, phòng, buồng ngủ	chamber
sự may mắn	chance
thay đổi, sự thay đổi, sự biến đổi	change
kênh (TV, radio), eo biển	channel
chương (sách)	chapter
tính cách, đặc tính, nhân vật	character
riêng, riêng biệt, đặc trưng, đặc tính, đặc điểm	characteristic
nhiệm vụ, bổn phận, trách nhiệm; giao nhiệm vụ, giao việc	charge
lòng từ thiện, lòng nhân đức; sự bố thí	charity
đồ thị, biểu đồ; vẽ đồ thị, lập biểu đồ	chart
săn bắt; sự săn bắt	chase
nói chuyện, tán gẫu; chuyện phiếm, chuyện gẫu	chat
rẻ	cheap
rẻ, rẻ tiền	cheaply
lừa, lừa đảo; trò lừa đảo, trò gian lận	cheat
kiểm tra; sự kiểm tra	check
má	cheek
vui mừng, phấn khởi, hồ hởi	cheerful
vui vẻ, phấn khởi	cheerfully
pho mát	cheese
thuộc hóa học; chất hóa học, hóa chất	chemical
nhà hóa học	chemist
(BrE)	chemist’s
hóa học, môn hóa học, ngành hóa học	chemistry
séc	cheque
tủ, rương, hòm	chest
nhai, ngẫm nghĩ	chew
gà, gà con, thịt gà	chicken
trọng yếu, chính yếu; thủ lĩnh, lãnh tụ, người đứng đầu, xếp	chief
đứa bé, đứa trẻ	child
cằm	chin
vỏ bào, mảnh vỡ, chỗ sứt, mẻ	chip
sô cô la	chocolate
sự lựa chọn	choice
chọn, lựa chọn	choose
chặt, đốn, chẻ	chop
nhà thờ	church
điếu thuốc lá	cigarette
rạp xi nê, rạp chiếu bóng	cinema
đường tròn, hình tròn	circle
hoàn cảnh, trường hợp, tình huống	circumstance
người thành thị	citizen
thành phố	city
(thuộc) công dân	civil
đòi hỏi, yêu sách; sự đòi hỏi, sự yêu sách, sự thỉnh cầu	claim
vỗ, vỗ tay; tiếng nổ, tiếng vỗ tay	clap
lớp học	class
cổ điển, kinh điển	classic
lớp học, phòng học	classroom
sạch, sạch sẽ;	clean
lau chùi, quét dọn	clear
rõ ràng, sáng sủa	clearly
thư ký, linh mục, mục sư	clerk
lanh lợi, thông minh. tài giỏi, khéo léo	clever
làm thành tiếng lách cách; tiếng lách cách, cú nhắp (chuột)	click
khách hàng	client
khí hậu, thời tiết	climate
leo, trèo	climb
sự leo trèo	climbing
đồng hồ	clock
đóng kín, chật chội, che đậy	close
chặt chẽ, kỹ lưỡng, tỉ mỉ	closely
đóng, khép, kết thúc, chấm dứt	close
bảo thủ, không cởi mở, khép kín	closed
buồng, phòng để đồ, phòng kho	closet
vải, khăn trải bàn, áo thầy tu	cloth
quần áo	clothes
quần áo, y phục	clothing
mây, đám mây	cloud
câu lạc bộ; gậy, dùi cui	club
xen ti mét	centimetre
huấn luyện viên	coach
than đá	coal
sự lao dốc; bờ biển	coast
áo choàng	coat
mật mã, luật, điều lệ	code
cà phê	coffee
tiền kim loại	coin
lạnh, sự lạnh lẽo, lạnh nhạt	cold
lạnh nhạt, hờ hững, vô tâm	coldly
đổ, sụp đổ; sự đổ nát, sự sụp đổ	collapse
bạn đồng nghiệp	colleague
sưu tập, tập trung lại	collect
sự sưu tập, sự tụ họp	collection
trường cao đẳng, trường đại học	college
màu sắc; tô màu	colour
mang màu sắc, có màu sắc	coloured
cột , mục (báo)	column
sự kết hợp, sự phối hợp	combination
kết hợp, phối hợp	combine
đến, tới, đi đến, đi tới	come
hài kịch	comedy
sự an ủi, khuyên giải, lời động viên, sự an nhàn; dỗ dành, an ủi	comfort
thoải mái, tiện nghi, đầy đủ	comfortable
dễ chịu, thoải mái, tiện nghi, ấm cúng	comfortably
bất tiện, khó chịu, không thoải mái	uncomfortable
ra lệnh, chỉ huy; lệnh, mệnh lệnh, quyền ra lệnh, quyền chỉ huy	command
lời bình luận, lời chú giải; bình luận, phê bình, chú thích, dẫn giải	comment
buôn bán, thương mại	commercial
hội đồng, ủy ban, sự ủy nhiệm, sự ủy thác; ủy nhiệm, ủy thác	commission
giao, gửi, ủy nhiệm, ủy thác; tống giam, bỏ tù	commit
sự phạm tội, sự tận tụy, tận tâm	commitment
ủy ban	committee
công, công cộng, thông thường, phổ biến	common
thông thường, bình thường	commonly
truyền, truyền đạt; giao thiệp, liên lạc	communicate
sự giao tiếp, liên lạc, sự truyền đạt, truyền tin	communication
dân chúng, nhân dân	community
công ty	company
so sánh, đối chiếu	compare
sự so sánh	comparison
đua tranh, ganh đua, cạnh tranh	compete
sự cạnh tranh, cuộc thi, cuộc thi đấu	competition
cạnh tranh, đua tranh	competitive
phàn nàn, kêu ca	complain
lời than phiền, than thở; sự khiếu nại, đơn kiện	complaint
hoàn thành, xong;	complete
hoàn thành, đầy đủ, trọn vẹn	completely
phức tạp, rắc rối	complex
làm phức tạp, rắc rối	complicate
phức tạp, rắc rối	complicated
máy tính	computer
tập trung	concentrate
sự tập trung, nơi tập trung	concentration
khái niệm	concept
liên quan, dính líu tới; sự liên quan, sự dính líu tới	concern
có liên quan, có dính líu	concerned
bâng khuâng, ái ngại	concerning
buổi hòa nhạc	concert
kết luận, kết thúc, chấm dứt (công việc)	conclude
sự kết thúc, sự kết luận, phần kết luận	conclusion
bằng bê tông; bê tông	concrete
điều kiện, tình cảnh, tình thế	condition
or/kən'dʌkt/ điều khiển, chỉ đạo, chỉ huy; sự điều khiển, chỉ huy	conduct
hội nghị, sự bàn bạc	conference
lòng tin tưởng, sự tin cậy	confidence
tin tưởng, tin cậy, tự tin	confident
tự tin	confidently
giam giữ, hạn chế	confine
hạn chế, giới hạn	confined
xác nhận, chứng thực	confirm
xung đột, va chạm; sự xung đột, sự va chạm	conflict
đối mặt, đối diện, đối chiếu	confront
làm lộn xộn, xáo trộn	confuse
khó hiểu, gây bối rối	confusing
bối rối, lúng túng, ngượng	confused
sự lộn xộn, sự rối loạn	confusion
sự chúc mừng, khen ngợi; lời chúc mừng, khen ngợi (s)	congratulations
đại hội, hội nghị, Quốc hội	congress
kết nối, nối	connect
sự kết nối, sự giao kết	connection
tỉnh táo, có ý thức, biết rõ	conscious
bất tỉnh, không có ý thức, không biết rõ	unconscious
kết quả, hậu quả	consequence
thận trọng, dè dặt, bảo thủ	conservative
cân nhắc, xem xét; để ý, quan tâm, lưu ý đến	consider
lớn lao, to tát, đáng kể	considerable
đáng kể, lớn lao, nhiều	considerably
sự cân nhắc, sự xem xét, sự để ý, sự quan tâm	consideration
gồm có	consist
kiên trì, bền lòng	constant
kiên định	constantly
xây dựng	construct
sự xây dựng	construction
tra cứu, tham khảo, thăm dò, hỏi ý kiến	consult
người tiêu dùng	consumer
sự liên lạc, sự giao thiệp; tiếp xúc	contact
bao hàm, chứa đựng, bao gồm	contain
cái đựng, chứa; công te nơ	container
đương thời, đương đại	contemporary
nội dung, sự hài lòng	content
cuộc thi, trận đấu, cuộc tranh luận, cuộc chiến đấu, chiến tranh	contest
văn cảnh, khung cảnh, phạm vi	context
lục địa, đại lục (lục địa Bắc Mỹ)	continent
tiếp tục, làm tiếp	continue
liên tục, liên tiếp	continuous
liên tục, liên tiếp	continuously
hợp đồng, sự ký hợp đồng; ký kết	contract
or /'kɔntræst / sự tương phản; làm tương phản, làm trái ngược	contrast
tương phản	contrasting
đóng góp, ghóp phần	contribute
sự đóng góp, sự góp phần	contribution
sự điều khiển, quyền hành, quyền lực, quyền chỉ huy	control
được điều khiển, được kiểm tra	controlled
không bị điều khiển, không bị kiểm tra, không bị hạn chế	uncontrolled
tiện lợi, thuận lợi, thích hợp	convenient
hội nghị, hiệp định, quy ước	convention
quy ước	conventional
cuộc đàm thoại, cuộc trò chuyện	conversation
đổi, biến đổi	convert
làm cho tin, thuyết phục; làm cho nhận thức thấy	convince
nấu ăn, người nấu ăn	cook
sự nấu ăn, cách nấu ăn	cooking
lò, bếp, nồi nấu	cooker
bánh quy	cookie
mát mẻ, điềm tĩnh; làm mát,	cool
đối phó, đương đầu	cope
bản sao, bản chép lại; sự sao chép; sao chép, bắt chước	copy
nòng cốt, hạt nhân; đáy lòng	core
góc (tường, nhà, phố...)	corner
đúng, chính xác; sửa, sửa chữa	correct
đúng, chính xác	correctly
giá, chi phí; trả giá, phải trả	cost
nhà tranh	cottage
bông, chỉ, sợi	cotton
ho, sự ho, tiếng hoa	cough
ho	coughing
có thể, có khả năng	could
hội đồng	council
đếm, tính	count
quầy hàng, quầy thu tiền, máy đếm	counter
nước, quốc gia, đất nước	country
miền quê, miền nông thôn	countryside
hạt, tỉnh	county
đôi, cặp; đôi vợ chồng, cặp nam nữ	couple
sự can đảm, sự dũng cảm, dũng khí	courage
tiến trình, quá trình diễn tiến; sân chạy đua	course
sân, sân (tennis...), tòa án, quan tòa, phiên tòa	court
anh em họ	cousin
bao bọc, che phủ; vỏ, vỏ bọc	cover
có mái che, kín đáo	covered
sự bao bọc, sự che phủ, cái bao, bọc	covering
con bò cái	cow
cừ, xuất sắc; làm nứt, làm vỡ, nứt nẻ, rạn nứt	crack
rạn, nứt	cracked
nghề, nghề thủ công	craft
vải thô; sự rơi (máy bay), sự phá sản, sụp đổ; phá tan tành, phá vụn	crash
điên, mất trí	crazy
kem	cream
sáng tạo, tạo nên	create
sinh vật, loài vật	creature
sự tin, lòng tin, danh tiếng; tiền gửi ngân hàng	credit
thẻ tín dụng	credit
tội, tội ác, tội phạm	crime
có tội, phạm tội; kẻ phạm tội, tội phạm	criminal
sự khủng hoảng, cơn khủng hoảng	crisis
giòn	crisp
tiêu chuẩn	criterion
phê bình, phê phán; khó tính	critical
sự phê bình, sự phê phán, lời phê bình, lời phê phán	criticism
phê bình, phê phán, chỉ trích	criticize
vụ mùa	crop
cây Thánh Giá, nỗi thống khổ; sự băng qua; băng qua, vượt qua	cross
đám đông	crowd
đông đúc	crowded
vương miện, vua, ngai vàng; đỉnh cao nhất	crown
quyết định, cốt yếu, chủ yếu	crucial
độc ác, dữ tợn, tàn nhẫn	cruel
ép, vắt, đè nát, đè bẹp	crush
khóc, kêu la; sự khóc, tiếng khóc, sự kêu la	cry
(thuộc) văn hóa	cultural
văn hóa, sự mở mang, sự giáo dục	culture
tách, chén	cup
1 loại tủ có ngăn	cupboard
kiềm chế, nén lại, hạn chế	curb
chữa trị, điều trị; cách chữa bệnh, cách điều trị; thuốc	cure
ham muốn, tò mò, lạ lùng	curious
tò mò, hiếu kỳ, lạ kỳ	curiously
quăn, xoắn, uốn quăn, làm xoắn; sự uốn quăn	curl
quăn, xoắn	curly
hiện hành, phổ biến, hiện nay; dòng (nước), luống (gió)	current
hiện thời, hiện nay	currently
màn (cửa, rạp hát, khói, sương)	curtain
đường cong, đường vòng; cong, uốn cong, bẻ cong	curve
cong	curved
phong tục, tục lệ, thói quen, tập quán	custom
khách hàng	customer
thuế nhập khẩu, hải quan	customs
cắt, chặt; sự cắt	cut
chu kỳ, chu trình, vòng; quay vòng theo chu kỳ, đi xe đạp	cycle
sự đi xe đạp	cycling
bố, cha	dad
hàng ngày	daily
mối hạn, điều hại, sự thiệt hại; làm hư hại, làm hỏng, gây thiệt hại	damage
ẩm, ẩm ướt, ẩm thấp	damp
sự nhảy múa, sự khiêu vũ; nhảy múa, khiêu vũ	dance
sự nhảy múa, sự khiêu vũ	dancing
diễn viên múa, người nhảy múa	dancer
sự nguy hiểm, mối hiểm nghèo; nguy cơ, mối đe dọa	danger
nguy hiểm	dangerous
dám, dám đương đầu với; thách	dare
tối, tối tăm; bóng tối, ám muội	dark
số liệu, dữ liệu	data
ngày, kỳ, kỳ hạn, thời kỳ, thời đại; đề ngày tháng, ghi niên hiệu	date
con gái	daughter
ngày, ban ngày	day
chết, tắt	dead
điếc, làm thinh, làm ngơ	deaf
phân phát, phân phối; sự giao dịch, thỏa thuận mua bán	deal
thân, thân yêu, thân mến; kính thưa, thưa	dear
sự chết, cái chết	death
cuộc tranh luận, cuộc tranh cãi; tranh luận, bàn cãi	debate
nợ	debt
thập kỷ, bộ mười, nhóm mười	decade
tình trạng suy tàn, suy sụp, tình trạng đổ nát	decay
tháng mười hai, tháng Chạp	December
quyết định, giải quyết, phân xử	decide
sự quyết định, sự giải quyết, sự phân xử	decision
tuyên bố, công bố	declare
sự suy tàn, sự suy sụp; suy sụp, suy tàn	decline
trang hoàng, trang trí	decorate
sự trang hoàng, đồ trang hoàng, trang trí	decoration
để trang hoàng, để trang trí, để làm cảnh	decorative
giảm bớt, làm suy giảm, sự giảm đi, sự giảm sút	decrease
sâu, khó lường, bí ẩn	deep
sâu, sâu xa, sâu sắc	deeply
đánh thắng, đánh bại; sự thất bại (1 kế hoạch), sự tiêu tan (hy vọng..)	defeat
cái để bảo vệ, vật để chống đỡ, sự che chở	defence
che chở, bảo vệ, bào chữa	defend
định nghĩa	define
xác định, định rõ, rõ ràng	definite
rạch ròi, dứt khoát	definitely
sự định nghĩa, lời định nghĩa	definition
mức độ, trình độ; bằng cấp; độ	degree
sự chậm trễ, sự trì hoãn, sự cản trở; làm chậm trễ	delay
thận trọng, có tính toán, chủ tâm, có suy nghĩ cân nhắc	deliberate
thận trọng, có suy nghĩ cân nhắc	deliberately
thanh nhã, thanh tú, tế nhị, khó xử	delicate
sự vui thích, sự vui sướng, điều thích thú; làm vui thích, làm say mê	delight
vui mừng, hài lòng	delighted
cứu khỏi, thoát khỏi, bày tỏ, giãi bày	deliver
sự phân phát, sự phân phối, sự giao hàng; sự bày tỏ, phát biếu	delivery
sự đòi hỏi, sự yêu cầu; đòi hỏi, yêu cầu	demand
chứng minh, giải thích; bày tỏ, biểu lộ	demonstrate
nha sĩ	dentist
từ chối, phản đối, phủ nhận	deny
cục, sở, ty, ban, khoa; gian hàng, khu bày hàng	department
sự rời khỏi, sự đi, sự khởi hành	departure
phụ thuộc, tùy thuộc; dựa vào, ỷ vào, trông mong vào	depend
vật gửi, tiền gửi, tiền đặt cọc; gửi, đặt cọc	deposit
làm chán nản, làm phiền muộn; làm suy giảm	depress
làm chán nản làm thát vọng, làm trì trệ	depressing
chán nản, thất vọng, phiền muộn; suy yếu, đình trệ	depressed
chiều sâu, độ dày	depth
nhận được từ, lấy được từ; xuất phát từ, bắt nguồn, chuyển hóa từ (from)	derive
diễn tả, miêu tả, mô tả	describe
sự mô tả, sự tả, sự miêu tả	description
sa mạc; công lao, giá trị; rời bỏ, bỏ trốn	desert
hoang vắng, không người ở	deserted
đáng, xứng đáng	deserve
sự thiết kế, kế hoạch, đề cương. phác thảo; phác họa, thiết kế	design
ước muốn; thèm muốn, ao ước	desire
bàn (học sinh, viết, làm việc)	desk
liều mạng, liều lĩnh; tuyệt vọng	desperate
liều lĩnh, liều mạng	desperately
dù, mặc dù, bất chấp	despite
phá, phá hoại, phá huỷ, tiêu diệt, triệt phá	destroy
sự phá hoại, sự phá hủy, sự tiêu diệt	destruction
chi tiết	detail
cặn kẽ, tỉ mỉ, nhiều chi tiết	detailed
sự xác định, sự định rõ; sự quyết định	determination
xác định, định rõ; quyết định	determine
đã được xác định, đã được xác định rõ	determined
phát triển, mở rộng; trình bày, bày tỏ	develop
sự phát triển, sự trình bày, sự bày tỏ	development
kế sách; thiết bị, dụng cụ, máy móc	device
hiến dâng, dành hết cho	devote
hiến cho, dâng cho, dành cho; hết lòng, nhiệt tình	devoted
biểu đồ	diagram
kim cương	diamond
sổ nhật ký; lịch ghi nhớ	diary
từ điển	dictionary
chết, từ trần, hy sinh	die
sự chết	dying
chế độ ăn uống, chế độ ăn kiêng	diet
sự khác nhau	difference
khác, khác biệt, khác nhau	different
khác, khác biệt, khác nhau	differently
khó, khó khăn, gay go	difficult
sự khó khăn, nỗi khó khăn, điều cản trở	difficulty
đào bới, xới	dig
bữa trưa, chiều	dinner
trực tiếp, thẳng, thẳng thắn; gửi, viết cho ai, điều khiển	direct
trực tiếp, thẳng	directly
sự điều khiển, sự chỉ huy	direction
giám đốc, người điều khiển, chỉ huy	director
đồ bẩn thỉu, đồ dơ bẩn, vật rác rưởi	dirt
bẩn thỉu, dơ bẩn	dirty
bất lực, không có khă năng	disabled
sự bất lợi, sự thiệt hại	disadvantage
bất đồng, không đồng ý, khác, không giống; không hợp	disagree
sự bất đồng, sự không đồng ý, sự khác nhau	disagreement
biến mất, biến đi	disappear
không làm thỏa ước nguyện, ý mong đợi; thất ước, làm thất bại	disappoint
làm chán ngán, làm thất vọng	disappointing
thất vọng	disappointed
sự chán ngán, sự thất vọng	disappointment
sự phản đổi, sự không tán thành	disapproval
không tán thành, phản đối, chê	disapprove
phản đối	disapproving
tai họa, thảm họa	disaster
đĩa	disc
kỷ luật	discipline
sự bớt giá, sự chiết khấu, tiền bớt, chiết khấu	discount
khám phá, phát hiện ra, nhận ra	discover
sự khám phá, sự tìm ra, sự phát hiện ra	discovery
thảo luận, tranh luận	discuss
sự thảo luận, sự tranh luận	discussion
căn bệnh, bệnh tật	disease
làm ghê tởm, làm kinh tởm, làm phẫn nộ	disgust
làm ghê tởm, kinh tởm	disgusting
chán ghét, phẫn nộ	disgusted
đĩa (đựng thức ăn)	dish
bất lương, không thành thật	dishonest
bất lương, không lương thiện	dishonestly
đĩa, đĩa hát	disk
sự không ưa, không thích, sự ghét	dislike
giải tán (quân đội, đám đông); sa thải (người làm)	dismiss
bày tỏ, phô trương, trưng bày; sự bày ra, phô bày, trưng bày	display
tan rã, phân hủy, giải tán	dissolve
khoảng cách, tầm xa	distance
phân biệt, nhận ra, nghe ra	distinguish
phân bổ, phân phối, sắp xếp, phân loại	distribute
sự phân bổ, sự phân phối, phân phát, sự sắp xếp	distribution
huyện, quận	district
làm mất yên tĩnh, làm náo động, quấy rầy	disturb
xáo trộn	disturbing
chia, chia ra, phân ra	divide
sự chia, sự phân chia, sự phân loại	division
sự ly dị	divorce
đã ly dị	divorced
làm	do
tháo, gỡ; xóa bỏ, hủy bỏ	undo
bác sĩ y khoa, tiến sĩ	doctor
văn kiện, tài liệu, tư liệu	document
chó	dog
đô la Mỹ	dollar
vật nuôi trong nhà, (thuộc) nội trợ, quốc nội	domestic
chiếm ưu thế, có ảnh hưởng, chi phối; kiềm chế	dominate
cửa, cửa ra vào	door
chấm nhỏ, điểm; của hồi môn	dot
đôi, hai, kép; cái gấp đôi, lượng gấp đôi; làm gấp đôi	double
sự nghi ngờ, sự ngờ vực; nghi ngờ, ngờ vực	doubt
xuống	down
ở dưới nhà, ở tầng dưới; xống gác; tầng dưới	downstairs
xuống, đi xuống	downwards
xuống, đi xuống	downward
tá (12)	dozen
bản phác thảo, sơ đồ thiết kế; phác thảo, thiết kế	draft
lôi kéo, kéo lê	drag
kịch, tuồng	drama
như kịch, như đóng kịch, thích hợp với sân khấu	dramatic
đột ngột	dramatically
vẽ, kéo	draw
bản vẽ, bức vẽ, sự kéo	drawing
người vẽ, người kéo	drawer
giấc mơ, mơ	dream
quần áo, mặc (quần áo), ăn mặc	dress
cách ăn mặc	dressed
đồ uống; uống	drink
lái , đua xe; cuộc đua xe (điều khiển)	drive
sự lái xe, cuộc đua xe	driving
người lái xe	driver
chảy nhỏ giọt, rơi, rớt; giọt (nước, máu...)	drop
thuốc, dược phẩm; ma túy	drug
hiệu thuốc, cửa hàng dược phẩm	drugstore
cái trống, tiếng trống	drum
say rượu	drunk
khô, cạn; làm khô, sấy khô	dry
đến kỳ hạn (trả nợ); xứng đáng, thích đáng	due
chậm hiểu, ngu đần	dull
đổ rác; đống rác, nơi đổ rác	dump
trong lúc, trong thời gian	during
bụi, rác; rắc (bụi, phấn), quét bụi, phủi bụi	dust
sự tôn kính, kính trọng; bồn phận, trách nhiệm	duty
mỗi	each
nhau, lẫn nhau	each
tai	ear
sớm	early
kiếm (tiền), giành (phần thưởng)	earn
đất, trái đất	earth
sự thanh thản, sự thoải mái; làm thanh thản, làm yên tâm, làm dễ chịu	ease
hướng đông, phía đông, (thuộc) đông, ở phía đông	east
đông	eastern
dễ dàng, dễ tính, ung dung	easy
dễ dàng	easily
ăn	eat
(thuộc) Kinh tế	economic
sự tiết kiệm, sự quản lý kinh tế	economy
lưỡi, cạnh sắc	edge
nhà xuất bản, sự xuất bản	edition
người thu thập và xuất bản, chủ bút	editor
giáo dục, cho ăn học; rèn luyện	educate
được giáo dục, được đào tạo	educated
sự giáo dục, sự rèn luyện (kỹ năng)	education
hiệu ứng, hiệu quả, kết quả	effect
có kết quả, có hiệu lực	effective
có kết quả, có hiệu lực	effectively
có hiệu lực, có hiệu quả	efficient
có hiệu quả, hiệu nghiệm	efficiently
sự cố gắng, sự nỗ lực	effort
abbr. Viết tắt của cụm từ La tinh exempli gratia (for example)	e.g.
trứng	egg
mỗi, một; cũng phải thế	either
khuỷu tay	elbow
có tuổi, cao tuổi	elderly
bầu, quyết định	elect
sự bầu cử, cuộc tuyển cử	election
(thuộc) điện, có điện, phát điện	electric
(thuộc) điện	electrical
điện, điện lực; điện lực học	electricity
(thuộc) điện tử	electronic
thanh lịch, tao nhã	elegant
yếu tôd, nguyên tố	element
máy nâng, thang máy	elevator
khác, nữa; nếu không	else
ở một nơi nào khác	elsewhere
thư điện tử; gửi thư điện tử	email
lúng túng, làm ngượng nghịu; làm rắc rối, gây khó khăn	embarrass
làm lúng túng, ngăn trở	embarrassing
lúng túng, bối rối, ngượng; mang nợ	embarrassed
sự lúng túng, sự bối rối	embarrassment
nổi lên, hiện ra; nổi bật lên	emerge
tình trạng khẩn cấp	emergency
xự xúc động, sự cảm động, mối xác cảm	emotion
cảm động, xúc động, xúc cảm; dễ cảm động, dễ xúc cảm	emotional
xúc động	emotionally
sự nhấn mạnh, tầm quan trọng	emphasis
nhấn mạnh, làm nổi bật	emphasize
đế chế, đế quốc	empire
dùng, thuê ai làm gì	employ
thất nghiệp; không dùng, không sử dụng được	unemployed
người lao động, người làm công	employee
chủ, người sử dụng lao động	employer
sự thuê mướn	employment
sự thất nghiệp, nạn thất nghiệp	unemployment
trống, rỗng; đổ, dốc; uống, làm cạn	empty
làm cho có thể, có khả năng; cho phép ai làm gì	enable
chạm chán, bắt gặp; sự chạm trán, sự bắt gặp	encounter
động viên, ủng hộ, giúp đỡ, làm can đảm, mạnh dạn	encourage
niềm cổ vũ, động viên, khuyến khích, sự làm can đảm	encouragement
giới hạn, sự kết thúc; kết thúc, chấm dứt	end
sự kết thúc, sự chấm dứt; phần cuối, kết cục	ending
kẻ thù, quân địch	enemy
năng lượng, nghị lực, sinh lực	energy
hứa hẹn, cam kết, đính ước	engage
đã đính ước, đã hứa hôn; đã có người	engaged
máy, động cơ	engine
kỹ sư	engineer
nghề kỹ sư, công việc của kỹ sư	engineering
thưởng thức, thích thú cái gì, được hưởng, có được	enjoy
thú vị, thích thú	enjoyable
sự thích thú, sự có được, được hưởng	enjoyment
to lớn, khổng lồ	enormous
đủ	enough
sự điều tra, sự thẩm vấn	enquiry
bảo đảm, chắc chắn	ensure
đi vào, gia nhập	enter
giải trí, tiếp đón, chiêu đãi	entertain
giải trí	entertaining
người quản trò, người tiếp đãi, chiêu đãi	entertainer
sự giải trí, sự tiếp đãi, chiêu đãi	entertainment
sự hăng hái, sự nhiệt tình	enthusiasm
hăng hái, say mê, nhiệt tình	enthusiastic
toàn thể, toàn bộ	entire
toàn vẹn, trọn vẹn, toàn bộ	entirely
cho tiêu đề, cho tên (sách); cho quyền làm gì	entitle
sự đi vào, sự nhậm chức	entrance
sự ghi vào sổ sách, sự đi vào, sự tiếp nhận (pháp lý)	entry
phong bì	envelope
môi trường, hoàn cảnh xung quanh	environment
thuộc về môi trường	environmental
ngang, bằng; người ngang hàng, ngang tài, sức; bằng, ngang	equal
bằng nhau, ngang bằng	equally
trang, thiết bị	equipment
tương đương; từ, vật tương đương	equivalent
lỗi, sự sai sót, sai lầm	error
trốn thoát, thoát khỏi; sự trốn thoát, lỗi thoát	escape
đặc biệt là, nhất là	especially
bài tiểu luận	essay
bản chất, thực chất, cốt yếu; yếu tố cần thiết	essential
về bản chất, về cơ bản	essentially
lập, thành lập	establish
tài sản, di sản, bất động sản	estate
sự ước lượng, đánh giá; ước lượng, đánh giá	estimate
vân vân	etc.
đơn vị tiền tệ của liên minh châu Âu	euro
ngay cả, ngay, lại còn; bằng phẳng, điềm đạm, ngang bằng	even
buổi chiều, tối	evening
sự việc, sự kiện	event
cuối cùng	eventually
từng, từ trước tới giờ	ever
mỗi, mọi	every
mọi người	everyone
mọi vật, mọi thứ	everything
mọi nơi	everywhere
điều hiển nhiên, điều rõ ràng	evidence
xấu, ác; điều xấu, điều ác, điều tai hại	evil
chính xác, đúng	exact
chính xác, đúng đắn	exactly
cường điệu, phóng đại	exaggerate
cường điệu, phòng đại	exaggerated
viết tắt của Examination (xem nghĩa phía dưới)	exam
n. sự thi cử, kỳ thi	examination
thẩm tra, khám xét, hỏi han (thí sinh)	examine
thí dụ, ví dụ	example
xuất sắc, xuất chúng	excellent
trừ ra, không kể; trừ phi	except
sự trừ ra, sự loại ra	exception
trao đổi; sự trao đổi	exchange
kích thích, kích động	excite
hứng thú, thú vị	exciting
bị kích thích, bị kích động	excited
sự kích thích, sự kích động	excitement
ngăn chạn, loại trừ	exclude
ngoài ra, trừ ra	excluding
lời xin lỗi, bào chữa; xin lỗi, tha thứ, tha lỗi	excuse
sự thi hành, chấp hành; (thuộc) sự thi hành, chấp hành	executive
bài tập, sự thi hành, sự thực hiện; làm, thi hành, thực hiện	exercise
trưng bày, triển lãm; vật trưng bày, vật triển lãm	exhibit
cuộc triển lãm, trưng bày	exhibition
tồn tại, sống	exist
sự tồn tại, sự sống	existence
lỗi ra, sự đi ra, thoát ra	exit
mở rộng, phát triển, nở, giãn ra	expand
chờ đợi, mong ngóng; liệu trước	expect
được chờ đợi, được hy vọng	expected
bất ngờ, gây ngạc nhiên	unexpected
bất ngờ, gây ngạc nhiên	unexpectedly
sự mong chờ, sự chờ đợi	expectation
chi phí	expense
đắt	expensive
kinh nghiệm; trải qua, nếm mùi	experience
có kinh nghiệm, từng trải, giàu kinh nghiệm	experienced
cuộc thí nghiệm; thí nghiệm	experiment
chuyên gia; chuyên môn, thành thạo	expert
giải nghĩa, giải thích	explain
sự giải nghĩa, giải thích	explanation
đập tan (hy vọng...), làm nổ, nổ	explode
thăm dò, thám hiểm	explore
sự nổ, sự phát triển ồ ạt	explosion
xuất khẩu; hàng xuất khẩu, sự xuất khẩu	export
trưng bày, phơi bày	expose
diễn tả, biểu lộ, bày tỏ; nhanh, tốc hành	express
sự diễn tả, sự bày tỏ, biểu lộ, sự diễn đạt	expression
giơ, duỗi ra (tay, chân..); kéo dài (thời gian..), dành cho, gửi lời	extend
sự giơ, duỗi; sự kéo dài, sự dành cho, gửi lời	extension
rộng rãi, bao quát	extensive
quy mô, phạm vi	extent
thêm, phụ, ngoại; thứ thêm, phụ	extra
đặc biệt, lạ thường, khác thường	extraordinary
vô cùng, khắc nghiệt, quá khích, cực đoan; sự quá khích	extreme
vô cùng, cực độ	extremely
mắt	eye
mặt, thể diện; đương đầu, đối phó, đối mặt	face
điều kiện dễ dàng, sự dễ dàng, thuận lợi	facility
việc, sự việc, sự kiện	fact
nhân tố	factor
nhà máy, xí nghiệp, xưởng	factory
sai, thất bại	fail
sự thất bại, người thất bại	failure
nhút nhát, yếu ớt	faint
nhút nhát, yếu ớt	faintly
hợp lý, công bằng; thuận lợi	fair
hợp lý, công bằng	fairly
gian lận, không công bằng; bất lợi	unfair
gian lận, không công bằng; bất lợi	unfairly
sự tin tưởng, tin cậy; niềm tin, vật đảm bảo	faith
trung thành, chung thủy, trung thực	faithful
trung thành, chung thủy, trung thực	faithfully
rơi, ngã, sự rơi, ngã	fall
sai, nhầm, giả dối	false
tên tuổi, danh tiếng	fame
thân thiết, quen thộc	familiar
gia đình, thuộc gia đình	family
nổi tiếng	famous
người hâm mộ	fan
tưởng tượng, cho, nghĩ rằng; tưởng tượng	fancy
xa	far
xa hơn nữa; thêm nữa	further
trang trại	farm
công việc trồng trọt, đồng áng	farming
nông dân, người chủ trại	farmer
mốt, thời trang	fashion
đúng mốt, hợp thời trang	fashionable
nhanh	fast
buộc, trói	fasten
béo, béo bở; mỡ, chất béo	fat
cha (bố)	father
vòi (ở thùng rượu....)	faucet
sự thiết sót, sai sót	fault
thiện ý, sự quý mến; sự đồng ý; sự chiếu cố	favour
favor (of) ủng hộ cái gì (to be in favour of something )	in
được ưa thích; người (vật) được ưa thích	favourite
sự sợ hãi, e sợ; sợ, lo ngại	fear
lông chim	feather
nét đặt biệt, điểm đặc trưng; mô tả nét đặc biệt, đặc trưng của...	feature
tháng 2	February
liên bang	federal
tiền thù lao, học phí	fee
cho ăn, nuôi	feed
cảm thấy	feel
sự cảm thấy, cảm giác	feeling
anh chàng (đang yêu), đồng chí	fellow
thuộc giống cái; giống cái	female
hàng rào	fence
lễ hội, đại hội liên hoan	festival
tìm về, đem về; làm bực mình; làm say mê, quyến rũ	fetch
cơn sốt, bệnh sốt	fever
ít,vài; một ít, một vài	few
cánh đồng, bãi chiến trường	field
đấu tranh, chiến đấu; sự đấu tranh, cuộc chiến đấu	fight
sự chiến đấu, sự đấu tranh	fighting
hình dáng, nhân vật; hình dung, miêu tả	figure
hồ sơ, tài liệu	file
làm đấy, lấp kín	fill
phim, được dựng thành phim	film
cuối cùng, cuộc đấu chung kết	final
cuối cùng, sau cùng	finally
tài chính; tài trợ, cấp vốn	finance
thuộc (tài chính)	financial
tìm, tìm thấy	find
tốt, giỏi	fine
đẹp đẽ, tế nhị, cao thượng	finely
ngón tay	finger
kết thúc, hoàn thành; sự kết thúc, phần cuối	finish
hoàn tất, hoàn thành	finished
lửa; đốt cháy	fire
hãng, công ty; chắc, kiên quyết, vũng vàng, mạnh mẽ	firm
vững chắc, kiên quyết	firmly
thứ nhất, đầu tiên, trước hết; người, vật đầu tiên, thứ nhất	first
cá, món cá; câu cá, bắt cá	fish
sự câu cá, sự đánh cá	fishing
hợp, vừa; thích hợp, xứng đáng	fit
đóng, gắn, lắp; sửa chữa, sửa sang	fix
đứng yên, bất động	fixed
quốc kỳ	flag
ngọn lửa	flame
loé sáng, vụt sáng; ánh sáng lóe lên, đèn nháy	flash
bằng phẳng, bẹt, nhẵn; dãy phòng, căn phòng, mặt phẳng	flat
vị, mùi; cho gia vị, làm tăng thêm mùi vị	flavour
thịt	flesh
sự bỏ chạy, rút chạy; sự bay, chuyến bay	flight
nổi, trôi, lơ lửng	float
lụt, lũ lụtl; tràn đầy, tràn ngập	flood
sàn, tầng (nhà)	floor
bột, bột mỳ	flour
sự chảy; chảy	flow
hoa, bông, đóa, cây hoa	flower
bệnh cúm	flu
bay; sự bay, quãng đường bay	fly
biết bay; sự bay, chuyến bay	flying
tập trung; trung tâm, trọng tâm (n.bóng)	focus
gấp, vén, xắn; nếp gấp	fold
gấp lại được	folding
đi theo sau, theo, tiếp theo	follow
tiếp theo, theo sau, sau đây; sau, tiếp theo	following
đồ ăn, thức, món ăn	food
chân, bàn chân	foot
bóng đá	football
cho, dành cho...	for
sức mạnh; ép buộc, cưỡng ép	force
sự dự đoán, dự báo; dự đoán, dự báo	forecast
(thuộc) nước ngoài, từ nước ngoài, ở nước ngoài	foreign
rừng	forest
mãi mãi	forever
quên	forget
tha, tha thứ	forgive
cái nĩa	fork
hình thể, hình dạng, hình thức; làm thành, được tạo thành	form
hình thức	formal
chính thức	formally
trước, cũ, xưa, nguyên	former
trước đây, thuở xưa	formerly
công thức, thể thức, cách thức	formula
sự giàu có, sự thịnh vượng	fortune
về tương lai, sau này ở phía trước, tiến về phía trước	forward
ở phía trước, tiến về phía trước	forward
(q.k of find) tìm, tìm thấy	found
sự thành lập, sự sáng lập; tổ chức	foundation
cấu trúc, hệ thống; dàn xếp, bố trí	frame
miễn phí, tự do, giải phóng, trả tự do	free
tự do, thoải mái	freely
sự tự do; nền tự do	freedom
đóng băng, đông lạnh	freeze
lạnh giá	frozen
thường xuyên	frequent
thường xuyên	frequently
tươi, tươi tắn	fresh
tươi mát, khỏe khoắn	freshly
thứ Sáu	Friday
tủ lạnh	fridge
người bạn	friend
thân thiện, thân mật	friendly
không thân thiện, không có thiện cảm	unfriendly
tình bạn, tình hữu nghị	friendship
làm sợ, làm hoảng sợ	frighten
kinh khủng, khủng khiếp	frightening
hoảng sợ, khiếp sợ	frightened
frəm/ từ	from
mặt; đằng trước, về phía trước	front
sự đông lạnh, sự giá lạnh; làm đông, làm đóng băng	freeze
quả, trái cây	fruit
rán, chiên; thịt rán	fry
chất đốt, nhiên liệu	fuel
đầy, đầy đủ	full
đầy đủ, hoàn toàn	fully
sự vui đùa, sự vui thích; hài hước	fun
chức năng; họat động, chạy (máy)	function
kho, quỹ; tài trợ, tiền bạc, để tiền vào công quỹ	fund
cơ bản, cơ sở, chủ yếu	fundamental
lễ tang, đám tang	funeral
buồn cười, khôi hài	funny
bộ da lông thú	fur
đồ đạc (trong nhà)	furniture
tương lai	future
lợi, lợi ích; giành được, kiếm được, đạt tới	gain
Galông 1gl = 4, 54 lít ở Anh, 3, 78 lít ở Mỹ	gallon
đánh bạc; cuộc đánh bạc	gamble
trò cờ bạc	gambling
trò chơi	game
đèo, lỗ hổng, kẽ hở; chỗ trống	gap
nhà để ô tô	garage
lòng, ruột (thú)	garbage
vườn	garden
khí, hơi đốt	gas
dầu lửa, dầu hỏa, xăng	gasoline
cổng	gate
tập hợp; hái, lượm, thu thập	gather
cơ cấu, thiết bị, dụng cụ	gear
chung, chung chung; tổng	general
nói chung, đại thể	generally
sinh, đẻ ra	generate
sự sinh ra, sự phát sinh ra; thế hệ, đời	generation
rộng lượng, khoan hồng, hào phóng	generous
rộng lượng, hào phóng	generously
hiền lành, dịu dàng, nhẹ nhàng	gentle
nhẹ nhàng, êm ái, dịu dàng	gently
người quý phái, người thượng lưu	gentleman
thành thật, chân thật; xác thực	genuine
thành thật, chân thật	genuinely
địa lý, khoa địa lý	geography
được, có được	get
người khổng lồ, người phi thường; khổng lồ, phi thường	giant
quà tặng	gift
con gái	girl
bạn gái, người yêu	girlfriend
cho, biếu, tặng	give
vui lòng, sung sướng	glad
kính, thủy tinh, cái cốc, ly	glass
kính đeo mắt	glasses
toàn cầu, toàn thể, toàn bộ	global
bao tay, găng tay	glove
keo, hồ; gắn lại, dán bằng keo, hồ	glue
đậu xanh	gram
đi	go
	goal
thần, Chúa	god
vàng; bằng vàng	gold
tốt, hay, tuyệt; điều tốt, điều thiện	good
tạm biệt; lời chào tạm biệt	goodbye
của cải, tài sản, hàng hóa	goods
cai trị, thống trị, cầm quyền	govern
chính phủ, nội các; sự cai trị	government
thủ lĩnh, chủ; kẻ thống trị	governor
túm lấy, vồ, chộp lấy	grab
điểm, điểm số; phân loại, xếp loại	grade
dần dần, từng bước một	gradual
dần dần, từ từ	gradually
thóc lúa, hạt, hột; tính chất, bản chất	grain
ngữ pháp	gram
văn phạm	grammar
rộng lớn, vĩ đại	grand
cháu (của ông bà)	grandchild
cháu gái	granddaughter
ông	grandfather
bà	grandmother
ông bà	grandparent
cháu trai	grandson
cho, ban, cấp; sự cho, sự ban, sự cấp	grant
cỏ; bãi cỏ, đồng cỏ	grass
biết ơn, dễ chịu, khoan khoái	grateful
mộ, dấu huyền; trang nghiêm, nghiêm trọng	grave
xám, hoa râm (tóc)	gray(NAmE)
xám, hoa râm (tóc)	grey
to, lớn, vĩ đại	great
rất, lắm; cao thượng, cao cả	greatly
xanh lá cây	green
cửa hàng tạp phẩm	grocery
hàng tạp hóa	groceries
mặt đất, đất, bãi đất	ground
nhóm	group
mọc, mọc lên	grow
sự lớn lên, sự phát triển	growth
sự bảo hành, bảo lãnh, người bảo lãnh; cam đoan, bảo đảm	guarantee
cái chắn, người bảo vệ; bảo vệ, gác, canh giữ	guard
đoán, phỏng đoán; sự đoán, sự ước chừng	guess
khách, khách mời	guest
điều chỉ dẫn, người hướng dẫn; dẫn đường, chỉ đường	guide
có tội, phạm tội, tội lỗi	guilty
súng	gun
bù nhìn, anh chàng, gã	guy
thói quen, tập quán	habit
tóc	hair
thợ làm tóc	hairdresser
một nửa, phần chia đôi, nửa giờ; nửa	half
đại sảnh, tòa (thị chính), hội trường	hall
búa	hammer
tay, bàn tay; trao tay, truyền cho	hand
cầm, sờ mó; tay cầm, móc quai	handle
treo, mắc	hang
xảy ra, xảy đến	happen
sự sung sướng, hạnh phúc	happiness
nỗi buồn, sự bất hạnh	unhappiness
vui sướng, hạnh phúc	happy
sung sướng, hạnh phúc	happily
buồn rầu, khốn khổ	unhappy
cứng, rắn, hà khắc; hết sức cố gắng, tích cực	hard
khắc nghiệt, nghiêm khắc, tàn tệ, khó khăn	hardly
thiệt hại, tổn hao; làm hại, gây thiệt hại	harm
gây tai hại, có hại	harmful
không có hại	harmless
cái mũ	hat
ghét; lòng căm ghét, thù hận	hate
lòng căm thì, sự căm ghét	hatred
có	have
phải (bắt buộc, có bổn phận phải)	have
nó, anh ấy, ông ấy	he
cái đầu (người, thú); chỉ huy, lãnh đại, dẫn đầu	head
chứng nhức đầu	headache
chữa khỏi, làm lành	heal
sức khỏe, thể chất, sự lành mạnh	health
khỏe mạnh, lành mạnh	healthy
nghe	hear
sự nghe, thính giác	hearing
tim, trái tim	heart
hơi nóng, sức nóng	heat
sự đốt nóng, sự làm nóng	heating
thiên đường	heaven
nặng, nặng nề	heavy
nặng, nặng nề	heavily
gót chân	heel
chiều cao, độ cao; đỉnh, điểm cao	height
địa ngục	hell
chào, xin chào; lời chào	hello
giúp đỡ; sự giúp đỡ	help
có ích; giúp đỡ	helpful
sau đây, kể từ đây; do đó, vì thế	hence
nó, chị ấy, cô ấy, bà ấy	her
cái của nó, cái của cô ấy, cái của chị ấy, cái của bà ấy	hers
đây, ở đây	here
người anh hùng	hero
chính nó, chính cô ta, chính chị ta, chính bà ta	herself
ngập ngừng, do dự	hesitate
xin chào	hi
trốn, ẩn nấp; che giấu	hide
cao, ở mức độ cao	high
tốt, cao; hết sức, ở mức độ cao	highly
làm nổi bật, nêu bật; chỗ nổi bật nhất, đẹp, sáng nhất	highlight
đường quốc lộ	highway
đồi	hill
nó, hắn, ông ấy, anh ấy	him
chính nó, chính hắn, chính ông ta, chính anh ta	himself
hông	hip
thuê, cho thuê (nhà...); sự thuê, sự cho thuê	hire
của nó, của hắn, của ông ấy, của anh ấy; cái của nó, cái của hắn, cái của ông ấy, cái của anh ấy	his
lịch sử, thuộc lịch sử	historical
lịch sử, sử học	history
đánh, đấm, ném trúng; đòn, cú đấm	hit
sở thích riêng	hobby
cầm, nắm, giữ; sự cầm, sự nắm giữ	hold
lỗ, lỗ trống; hang	hole
ngày lễ, ngày nghỉ	holiday
rỗng, trống rỗng	hollow
linh thiêng; sùng đạo	holy
nhà; ở tại nhà, nước mình	home
bài tập về nhà (học sinh), công việc làm ở nhà	homework
lương thiện, trung thực, chân thật	honest
lương thiện, trung thực, chân thật	honestly
danh dự, thanh danh, lòng kính trọng	honour
honor of để tỏ lòng tôn kính, trân trọng đối với	in
cái móc; bản lề; lưỡi câu	hook
hy vọng; nguồn hy vọng	hope
(thuộc) chân trời, ở chân trời; ngang, nằm ngang (trục hoành)	horizontal
sừng (trâu, bò...)	horn
điều kinh khủng, sự ghê rợn	horror
ngựa	horse
bệnh viện, nhà thương	hospital
chủ nhà, chủ tiệc; dẫn (c.trình), đăng cai tổ chức (hội nghị....)	host
nóng, nóng bức	hot
khách sạn	hotel
giờ	hour
nhà, căn nhà, toàn nhà	house
nơi ăn chốn ở	housing
hộ, gia đình; (thuộc) gia đình	household
thế nào, như thế nào, làm sao, ra sao	how
tuy nhiên, tuy vậy, dù thế nào	however
to lớn, khổng lồ	huge
(thuộc) con người, loài người	human
hài hước, hóm hỉnh	humorous
sự hài hước, sự hóm hỉnh	humour
đó	hungry
săn, đi săn	hunt
sự đi săn	hunting
sự vội vàng, sự gấp rút	hurry
làm bị thương, gây thiệt hại	hurt
người chồng	husband
băng, nước đá	ice
kem	ice
ý tưởng, quan niệm	idea
(thuộc) quan niệm, tư tưởng; lý tưởng	ideal
lý tưởng, đúng như lý tưởng	ideally
nhận biết, nhận ra, nhận dạng	identify
cá tính, nét nhận dạng; tính đồng nhất, giống hệt	identity
abbr. nghĩa là, tức là ( Id est)	i.e.
nếu, nếu như	if
phớt lờ, tỏ ra không biết đến	ignore
ốm	ill
trái luật, bất hợp pháp	illegal
trái luật, bất hợp pháp	illegally
sự đau yếu, ốm, bệnh tật	illness
minh họa, làm rõ ý	illustrate
ảnh, hình ảnh	image
tưởng tượng, ảo	imaginary
trí tưởng tượng, sự tưởng tượng	imagination
tưởng tượng, hình dung; tưởng rằng, cho rằng	imagine
lập tức, tức thì	immediate
ngay lập tức	immediately
trái đạo đức, luân lý; xấu xa	immoral
sự và chạm, sự tác động, ảnh hưởng	impact
thiếu kiên nhẫn, nóng vội	impatient
nóng lòng, sốt ruột	impatiently
sự lôi kéo, sự liên can, điều gợi ý	implication
ngụ ý, bao hàm	imply
import sự nhập, sự nhập khẩu; nhập, nhập khẩu	import
sự quan trọng, tầm quan trọng	importance
quan trọng, hệ trọng	important
quan trọng, trọng yếu	importantly
khônh quan trọng, không trọng đại	unimportant
đánh (thuế...), bắt gánh vác; đánh tráo, lợi dụng	impose
không thể làm được, không thể xảy ra	impossible
ghi, khắc, in sâu vào; gây ấn tượng, làm cảm động	impress
được ghi, khắc, in sâu vào	impressed
ấn tượng, cảm giác; sự in, đóng dấu	impression
gấy ấn tượng mạnh; hùng vĩ, oai vệ	impressive
cải thiện, cái tiến, mở mang	improve
sự cái thiện, sự cải tiến, sự mở mang	improvement
ở, tại, trong; vào	in
sự bất lực, bất tài	inability
insơ (đơn vị đo chiều dài Anh bằng 2, 54 cm)	inch
việc xảy ra, việc có liên quan	incident
bao gồm, tính cả	include
bao gồm, kể cả	including
lợi tức, thu nhập	income
or/'inkri:s/ tăng, tăng thêm; sự tăng, sự tăng thêm	increase
tăng thêm	increasingly
thật vậy, quả thật	indeed
sự độc lập, nền độc lập	independence
độc lập	independent
độc lập	independently
chỉ số, sự biểu thị	index
chỉ, cho biết; biểu thị, trình bày ngắn gọn	indicate
sự chỉ, sự biểu thị, sự biểu lộ	indication
gián tiếp	indirect
gián tiếp	indirectly
riêng, riêng biệt; cá nhân	individual
ở trong nhà	indoors
trong nhà	indoor
(thuộc) công nghiệp, kỹ nghệ	industrial
công nghiệp, kỹ nghệ	industry
không thể tránh được, chắc chắn xảy ra; vẫn thường thấy, nghe	inevitable
chắc chắn	inevitably
nhiễm, tiêm nhiễm, đầu độc, lan truyền	infect
bị nhiễm, bị đầu độc	infected
sự nhiễm, sự đầu độc	infection
lây, nhiễm	infectious
sự ảnh hưởng, sự tác dụng; ảnh hưởng, tác động	influence
báo cho biết, cung cấp tin tức	inform
không chính thức, không nghi thức	informal
tin tức, tài liệu, kiến thức	information
phần hợp thành, thành phần	ingredient
ban đầu, lúc đầu; chữ đầu (của 1 tên gọi)	initial
vào lúc ban đầu, ban đầu	initially
bước đầu, sự khởi đầu	initiative
làm tổn thương, làm hại, xúc phạm	injure
bị tổn thương, bị xúc phạm	injured
sự làm tổn thương, làm hại; điều hại, điều tổn hại	injury
mực	ink
ở trong, nội bộ; thân cận	inner
vô tội, trong trắng, ngây thơ	innocent
sự điều tra, sự thẩm vấn)	(enquiry
sâu bọ, côn trùng	insect
chèn vào, lồng vào	insert
mặt trong, phía, phần trong; ở trong, nội bộ	inside
cứ nhất định, cứ khăng khăng	insist
đặt (hệ thống máy móc, thiết bị...)	install
thí dị, ví dụ; trường hợp cá biệt	instance
để thay thế	instead
viện, học viện	institute
sự thành lập, lập; cơ quan, trụ sở	institution
sự dạy, tài liệu cung cấp	instruction
dụng cụ âm nhạc khí	instrument
lăng mạ, xỉ nhục; lời lăng mạ, sự xỉ nhục	insult
lăng mạ, xỉ nhục	insulting
sự bảo hiểm	insurance
sự hiểu biết, trí thông minh	intelligence
thông minh, sáng trí	intelligent
ý định, có ý định	intend
có ý định, có dụng ý	intended
ý định, mục đích	intention
or /ˈɪntrest/ sự thích thú, sự quan tâm, chú ý; làm quan tâm, làm chú ý	interest
làm thích thú, làm quan tâm, làm chú ý	interesting
có thích thú, có quan tâm, có chú ý	interested
phần trong, phía trong; ở trong, ở phía trong	interior
ở trong, bên trong, nội địa	internal
quốc tế	international
liên mạng	internet
giải thích	interpret
sự giải thích	interpretation
làm gián đoạn, ngắt lời	interrupt
sự gián đoạn, sự ngắt lời	interruption
khoảng (k-t.gian), khoảng cách	interval
cuộc phỏng vấn, sự gặp mặt; phỏng vấn, nói chuyện riêng	interview
or /'intə/ vào, vào trong	into
giới thiệu	introduce
sự giới thiệu, lời giới thiệu	introduction
phát minh, sáng chế	invent
sự phát minh, sự sáng chế	invention
đầu tư	invest
điều tra, nghiên cứu	investigate
sự điều tra, nghiên cứu	investigation
sự đầu tư, vốn đầu tư	investment
lời mời, sự mời	invitation
mời	invite
bao gồm, bao hàm; thu hút, dồn tâm trí	involve
sự gồm, sự bao hàm; sự để, dồn hết tâm trí vào	involvement
sắt; bọc sắt	iron
làm phát cáu, chọc tức	irritate
làm phát cáu, chọc tức	irritating
tức giận, cáu tiết	irritated
hòn đảo	island
sự phát ra, sự phát sinh; phát hành, đưa ra	issue
cái đó, điều đó, con vật đó	it
của cái đó, của điều đó, của con vật đó; cái của điều đó, cái của con vật đó	its
tin tức; khoản.., món..., tiết mục	item
chính cái đó, chính điều đó, chính con vật đó	itself
áo vét	jacket
mứt	jam
tháng giêng	January
ghen,, ghen tị	jealous
quần bò, quần zin	jeans
thạch	jelly
nữ trang, kim hoàn	jewellery
việc, việc làm	job
gia nhập, tham gia; nối, chắp, ghép	join
chung (giữa 2 người hoặc hơn); chỗ nối, đầu nối	joint
cùng nhau, cùng chung	jointly
trò cười, lời nói đùa; nói đùa, giễu cợt	joke
nhà báo	journalist
cuộc hành trình (đường bộ); quãng đường, chặng đường đi	journey
niềm vui, sự vui mừng	joy
xét xử, phân xử; quan tòa, thẩm phán	judge
sự xét xử	judgement
nước ép (rau, củ, quả)	juice
tháng 7	July
nhảy; sự nhảy, bước nhảy	jump
tháng 6	June
trẻ hơn, ít tuổi hơn; người ít tuổi hơn	junior
đúng, vừa đủ; vừa mới, chỉ	just
sự công bằng	justice
bào chữa, biện hộ	justify
hợp lý, được chứng minh là đúng	justified
sắc, bén	keen
giữ, giữ lại	keep
chìa khóa, khóa, thuộc (khóa)	key
bàn phím	keyboard
đá; cú đá	kick
con dê non	kid
giết, tiêu diệt	kill
sự giết chóc, sự tàn sát	killing
Kilôgam	kilogram
Kilômet	kilometre
loại, giống; tử tế, có lòng tốt	kind
tử tế, tốt bụng	kindly
độc ác, tàn nhẫn	unkind
sự tử tế, lòng tốt	kindness
vua, quốc vương	king
hôn, cái hôn	kiss
bếp	kitchen
Kilômet	kilometre
đầu gối	knee
con dao	knife
đan, thêu	knit
được đan, được thêu	knitted
việc đan; hàng dệt kim	knitting
đánh, đập; cú đánh	knock
cái nơ; điểm nút, điểm trung tâm	knot
biết	know
không biết	unknown
nổi tiếng, được nhiều người biết đến	well
sự hiểu biết, tri thức	knowledge
lít	litre
nhãn, mác; dán nhãn, ghi mác	label
phòng thí nghiệm	laboratory,
lao động; công việc	labour
sự thiếu; thiếu	lack
ngu đần, ngây ngô	lacking
người yêu, vợ, quý bà, tiểu thư	lady
hồ	lake
đèn	lamp
đất, đất canh tác, đất đai	land
phong cảnh	landscape
đường nhỏ (làng, hẻm phố)	lane
ngôn ngữ	language
rộng, lớn, to	large
phong phú, ở mức độ lớn	largely
lầm cuối, sau cùng; người cuối cùng; cuối cùng, rốt hết; kéo dài	last
trễ, muộn	late
chậm hơn	later
muộn nhất, chậm nhất, gần đây nhất	latest
sau cùng, gần đây, mới đây	latter
cười; tiếng cười	laugh
hạ thủy (tàu); khai trương; sự hạ thủy, buổi giới thiệu sản phầm	launch
luật	law
luật sư	lawyer
xếp, đặt, bố trí	lay
lớp	layer
lười biếng	lazy
v., n. lãnh đạo, dẫn dắt; sự lãnh đạo, sự hướng dẫn	lead
lãnh đạo, dẫn đầu	leading
người lãnh đạo, lãnh tụ	leader
lá cây, lá (vàng...)	leaf
liên minh, liên hoàn	league
nghiêng, dựa, ỷ vào	lean
học, nghiên cứu	learn
tối thiểu; ít nhất	least
da thuộc	leather
bỏ đi, rời đi, để lại	leave
bài diễn thuyết, bài thuyết trình, bài nói chuyện	lecture
bên trái; về phía trái	left
chân (người, thú, bàn...)	leg
hợp pháp	legal
hợp pháp	legally
quả chanh	lemon
cho vay, cho mượn	lend
chiều dài, độ dài	length
nhỏ bé, ít hơn; số lượng ít hơn	less
bài học	lesson
cho phép, để cho	let
thư; chữ cái, mẫu tự	letter
trình độ, cấp, vị trí; bằng, ngang bằng	level
thư viện	library
bằng, chứng chỉ, bằng cử nhân; sự cho phép	licence
cấp chứng chỉ, cấp bằng, cho phép	license
nắp, vung (xoong, nồi..); mi mắt (eyelid)	lid
nói dối; lời nói dối, sự dối trá	lie
đời, sự sống	life
giơ lên, nhấc lên; sự nâng, sự nhấc lên	lift
ánh sáng; nhẹ, nhẹ nhàng; đốt, thắp sáng	light
nhẹ nhàng	lightly
giống như; thích; như	like
khác, không giống	unlike
có thể đúng, có thể xảy ra, có khả năng; có thể, chắc vậy	likely
không thể xảy ra, không chắc xảy ra	unlikely
giới hạn, ranh giới; giới hạn, hạn chế	limit
hạn chế, có giới hạn	limited
dây, đường, tuyến	line
mắt xích, mối liên lạc; liên kết, kết nối	link
môi	lip
chất lỏng; lỏng, êm ái, du dương, không vững	liquid
danh sách; ghi vào danh sách	list
nghe, lắng nghe	listen
văn chương, văn học	literature
lít	litre
nhỏ, bé, chút ít; không nhiều; một chút	little
nhỏ, một ít	a
sống, hoạt động	live
sống	live
sống, đang sống	living
sống, sinh động	lively
gánh nặng, vật nặng; chất, chở	load
cất gánh nặng, dỡ hàng	unload
sự vay mượn	loan
địa phương, bộ phận, cục bộ	local
có tính chất địa phương, cục bộ	locally
xác định vị trí, định vị	locate
định vị	located
vị trí, sự định vị	location
khóa; khóa	lock
lô gic	logic
hợp lý, hợp logic	logical
cô đơn, bơ vơ	lonely
dài, xa; lâu	long
nhìn; cái nhìn	look
lỏng, không chặt	loose
lỏng lẻo	loosely
Chúa, vua	lord
xe tải	lorry
mất, thua, lạc	lose
thua, mất	lost
sự mất, sự thua	loss
số lượng lớn; rất nhiều	lot:
to, inh ỏi, ầm ĩ; to, lớn (nói)	loud
ầm ĩ, inh ỏi	loudly
tình yêu, lòng yêu thương; yêu, thích	love
đẹp, xinh xắn, có duyên	lovely
người yêu, người tình	lover
thấp, bé, lùn	low
trung thành, trung kiên	loyal
may mắn, vận may	luck
gặp may, gặp may mắn, hạnh phúc	lucky
không gặp may, bất hạnh	unlucky
hành lý	luggage
cục, tảng, miếng; cái bướu	lump
bữa ăn trưa	lunch
phổi	lung
máy, máy móc	machine
máy móc, thiết bị	machinery
điên, mất trí; bực điên người	mad
tạp chí	magazine
ma thuật, ảo thuật; (thuộc) ma thuật, ảo thuật	magic
thư từ, bưu kiện; gửi qua bưu điện	mail
chính, chủ yếu, trọng yếu nhất	main
chính, chủ yếu, phần lớn	mainly
giữ gìn, duy trì, bảo vệ	maintain
lớn, nhiều hơn, trọng đại, chủ yếu	major
phần lớn, đa số, ưu thế	majority
làm, chế tạo; sự chế tạo	make
đồ hóa trang, son phấn	make-up
trai, trống, đực; con trai, đàn ông, con trống, đực	male
búa	mall
con người; đàn ông	man
quản lý, trông nom, điều khiển	manage
sự quản lý, sự trông nom, sự điều khiển	management
người quản lý, giám đốc	manager
cách, lối, kiểu; dáng, vẻ, thái độ	manner
	manufacture
sự sản xuất, sự chế tạo	manufacturing
người chế tạo, người sản xuất	manufacturer
nhiều	many
bản đồ	map
tháng ba	March
diễu hành, hành quân; cuộc hành quân, cuộc diễu hành	march
dấu, nhãn, nhãn mác; đánh dấu, ghi dấu	mark
chợ, thị trường	market
ma-kết-tinh	marketing
sự cưới xin, sự kết hôn, lễ cưới	marriage
cưới (vợ), lấy (chồng)	marry
cưới, kết hôn	married
khối, khối lượng; quần chúng, đại chúng	mass
to lớn, đồ sộ	massive
chủ, chủ nhân, thầy giáo, thạc sĩ	master
trận thi đấu, đối thủ, địch thủ; đối chọi, sánh được	match
tính địch thù, thi đấu	matching
bạn, bạn nghề; giao phối	mate
nguyên vật liệu; vật chất, hữu hình	material
toán học, môn toán	mathematics
chất, vật chất; có ý nghĩa, có tính chất quan trọng	matter
cực độ, tối đa; trị số cực đại, lượng cực đại, cực độ	maximum
có thể, có lẽ	may
tháng 5	May
có thể, có lẽ	maybe
thị trưởng	mayor
tôi, tao, tớ	me
bữa ăn	meal
nghĩa, có nghĩa là	mean
ý, ý nghĩa	meaning
của cải, tài sản, phương tiện	means
trong lúc đó, trong lúc ấy	meanwhile
đo, đo lường; sự đo lường, đơn vị đo lường	measure
sự đo lường, phép đo	measurement
thịt	meat
phương tiện truyền thông đại chúng	media
(thuộc) y học	medical
y học, y khoa; thuốc	medicine
trung bình, trung, vừa; sự trung gian, sự môi giới	medium
gặp, gặp gỡ	meet
cuộc mít tinh, cuộc biểu tình	meeting
tan ra, chảy ra; làm tan chảy ra	melt
thành viên, hội viên	member
tư cách hội viên, địa vị hội viên	membership
bộ nhớ, trí nhớ, kỉ niệm	memory
(thuộc) trí tuệ, trí óc; mất trí	mental
về mặt tinh thần	mentally
kể ra, nói đến, đề cập	mention
thực đơn	menu
chỉ là	mere
chỉ, đơn thuần	merely
tình trạng bừa bộn, tình trạng lộn xộn; người nhếch nhác, bẩn thỉu	mess
tin nhắn, thư tín, điện thông báo, thông điệp	message
kim loại	metal
phương pháp, cách thức	method
mét	metre
trưa, buổi trưa	midday
giữa, ở giữa	middle
nửa đêm, 12h đêm	midnight
qk. may có thể, có lẽ	might
nhẹ, êm dịu, ôn hòa	mild
dặm (đo lường)	mile
(thuộc) quân đội, quân sự	military
sữa	milk
mi-li-gam	milligram
mi-li-met	millimetre
tâm trí, tinh thần, trí tuệ; chú ý, để ý, chăm sóc, quan tâm	mind
của tôi	mine
công nhân, thợ mỏ; khoáng	mineral
tối thiểu; số lượng tối thiểu, mức tối thiểu	minimum
bộ trưởng	minister
bộ	ministry
nhỏ hơn, thứ yếu, không quan trọng	minor
phần ít, thiểu số	minority
phút	minute
gương	mirror
lỡ, trượt; sự trượt, sự thiếu vắng	miss
cô gái, thiếu nữ	Miss
vắng, thiếu, thất lạc	missing
lỗi, sai lầm, lỗi lầm; phạm lỗi, phạm sai lầm	mistake
sai lầm, hiểu lầm	mistaken
pha, trộn lẫn; sự pha trộn	mix
lẫn lộn, pha trộn	mixed
sự pha trộn, sự hỗn hợp	mixture
chuyển động, di động	mobile
(BrE) điện thoại đi động	mobile
mẫu, kiểu mẫu	model
hiện đại, tân tiến	modern
mẹ	mum
chốc, lát	moment
thứ 2	Monday
tiền	money
lớp trưởng, màn hình máy tính; nghe, ghi phát thanh, giám sát	monitor
tháng	month
lối, thức, điệu	mood
mặt trăng	moon
(thuộc) đạo đức, luân lý, phẩm hạnh; có đạo đức	moral
có đạo đức	morally
hơn, nhiều hơn	more
hơn nữa, ngoài ra, vả lại	moreover
buổi sáng	morning
lớn nhất, nhiều nhất; nhất, hơn cả	most
hầu hết, chủ yếu là	mostly
mẹ	mother
sự chuyển động, sụ di động	motion
động cơ mô tô	motor
xe mô tô	motorcycle
leo, trèo; núi	mount
núi	mountain
chuột	mouse
miệng	mouth
di chuyển, chuyển động; sự di chuyển, sự chuyển động	move
động, hoạt động	moving
sự chuyển động, sự hoạt động; cử động, động tác	movement
phim xi nê	movie
(NAmE) rạp chiếu phim	movie
NAmE, BrE) abbr.	Mr
NAmE, BrE) abbr.	Mrs
NAmE, BrE) abbr.	Ms
nhiều, lắm	much
bùn	mud
nhân lên, làm tăng lên nhiều lần; sinh sôi nảy nở	multiply
mẹ	mum
tội giết người, tội ám sát; giết người, ám sát	murder
cơ, bắp thịt	muscle
bảo tàng	museum
nhạc, âm nhạc	music
(thuộc) nhạc, âm nhạc; du dương, êm ái	musical
nhạc sĩ	musician
phải, cần, nên làm	must
của tôi	my
tự tôi, chính tôi	myself
thần bí, huyền bí, khó hiểu	mysterious
điều huyền bí, điều thần bí	mystery
móng (tay, chân) móng vuốt	nail
trần, khỏa thân, trơ trụi	naked
tên; đặt tên, gọi tên	name
hẹp, chật hẹp	narrow
dân tộc, quốc gia	nation
(thuộc) quốc gia, dân tộc	national
(thuộc) tự nhiên, thiên nhiên	natural
vốn, tự nhiên, đương nhiên	naturally
tự nhiên, thiên nhiên	nature
hải quân	navy
gần, cận; ở gần	near
gần	nearby
gần, sắp, suýt	nearly
sạch, ngăn nắp; rành mạch	neat
gọn gàng, ngăn nắp	neatly
cần, cần thiết, thiết yếu	necessary
tất yếu, nhất thiết	necessarily
không cần thiết, không mong muốn	unnecessary
cổ	neck
cần, đòi hỏi; sự cần	need
cái kim, mũi nhọn	needle
phủ định	negative
hàng xóm	neighbour
hàng xóm, làng giềng	neighbourhood
không này mà cũng không kia	neither
cháu trai (con anh, chị, em)	nephew
khí lực, thần kinh, can đảm	nerve
hoảng sợ, dễ bị kích thích, hay lo lắng	nervous
bồn chồn, lo lắng	nervously
tổ, ổ; làm tổ	nest
lưới, mạng	net
mạng lưới, hệ thống	network
không bao giờ, không khi nào	never
tuy nhiên, tuy thế mà	nevertheless
mới, mới mẻ, mới lạ	new
mới	newly
tin, tin tức	news
báo	newspaper
sát, gần, bên cạnh; lần sau, tiếp nữa	next
gần	next
đẹp, thú vị, dễ chịu	nice
thú vị, dễ chịu	nicely
cháu gái	niece
đêm, tối	night
không	no
không ai, không người nào	nobody
tiếng ồn, sự huyên náo	noise
ồn ào, huyên náo	noisy
ồn ào, huyên náo	noisily
không ai, không người, vật gì	none
lời nói vô lý, vô nghĩa	nonsense
cũng không	nor
thường, bình thường; tình trạng bình thường	normal
thông thường, như thường lệ	normally
phía bắc, phương bắc	north
Bắc	northern
mũi	nose
không	not
lời ghi, lời ghi chép; ghi chú, ghi chép	note
không gì, không cái gì	nothing
thông báo, yết thị; chú ý, để ý, nhận biết	notice
đáng chú ý, đáng để ý	noticeable
tiểu thuyết, truyện	novel
tháng 11	November
bây giờ, hiện giờ, hiện nay	now
không nơi nào, không ở đâu	nowhere
(thuộc) hạt nhân	nuclear
số	number
y tá	nurse
quả hạch; đầu	nut
vâng lời, tuân theo, tuân lệnh	obey
vật, vật thể; phản đối, chống lại	object
mục tiêu, mục đích; (thuộc) mục tiêu, khách quan	objective
sự quan sát, sự theo dõi	observation
quan sát, theo dõi	observe
đạt được, giành được	obtain
rõ ràng, rành mạch, hiển nhiên	obvious
một cách rõ ràng, có thể thấy được	obviously
dịp, cơ hội	occasion
thỉnh thoảng, đôi khi	occasionally
giữ, chiếm lĩnh, chiếm giữ	occupy
đang sử dụng, đầy (người)	occupied
xảy ra, xảy đến, xuất hiện	occur
đại dương	ocean
đúng giờ	o’clock
tháng 10	October
kỳ quặc, kỳ cục, lẻ (số)	odd
kỳ quặc, kỳ cục, lẻ (số)	oddly
or /əv/ của	of
tắt; khỏi, cách, rời	off
sự vi phạm, sự phạm tội	offence
xúc phạm, làm bực mình, làm khó chịu	offend
sự tấn công, cuộc tấn công	offensive
biếu, tặng, cho; sự trả giá	offer
cơ quan, văn phòng, bộ	office
viên chức, cảnh sát, sĩ quan	officer
(thuộc) chính quyền, văn phòng; viên chức, công chức	official
một cách trịnh trọng, một cách chính thức	officially
thường, hay, luôn	often
chao, ôi chao, chà, này..	oh
dầu	oil
đồng ý, tán thành	OK
già	old
lỗi thời	old-fashioned
trên, ở trên; tiếp tục, tiếp diễn	on
một lần; khi mà, ngay khi, một khi	once
một; một người, một vật nào đó	one
củ hành	onion
chỉ có 1, duy nhất; chỉ, mới	only
về phía trên, lên trên	onto
mở, ngỏ; mở, bắt đầu, khai mạc	open
công khai, thẳng thắn	openly
khe hở, lỗ; sự bắt đầu, sự khai mạc, lễ khánh thành	opening
hoạt động, điều khiển	operate
sự hoạt động, quá trình hoạt động	operation
ý kiến, quan điểm	opinion
địch thủ, đối thủ, kẻ thù	opponent
cơ hội, thời cơ	opportunity
đối kháng, đối chọi, đối lập; chống đối, phản đối	oppose
tính đối kháng, đối chọi	opposing
chống lại, phản đối	opposed
đối nhau, ngược nhau; trước mặt, đối diện; điều trái ngược	opposite
sự đối lập, sự đối nhau; sự chống lại, sự phản đối; phe đối lập	opposition
sự lựa chọn	option
quả cam; có màu da cam	orange
thứ, bậc; ra lệnh	order
thường, thông thường	ordinary
đàn óoc gan	organ
tổ chức, cơ quan; sự tổ chức	organization
tổ chức, thiết lập	organize
có trật tự, ngăn nắp, được sắp xếp, được tổ chức	organized
gốc, nguồn gốc, căn nguyên	origin
(thuộc) gốc, nguồn gốc, căn nguyên; nguyên bản	original
một cách sáng tạo, mới mẻ, độc đáo; khởi đầu, đầu tiên	originally
khác	other
khác, cách khác; nếu không thì...; mặt khác	otherwise
phải, nên, hẳn là	ought
của chúng ta, thuộc chúng ta, của chúng tôi, của chúng mình	our
của chúng ta, thuộc chúng ta, của chúng tôi, của chúng mình	ours
bản thân chúng ta, bản thân chúng tôi, bản thân chúng mình; tự chúng mình	ourselves
ngoài, ở ngoài, ra ngoài	out
ở ngoài trời, ở ngoài nhà	outdoors
ngoài trời, ở ngoài	outdoor
outer ở phía ngoài, ở xa hơn	outer
vẽ, phác tảo; đường nét, hình dáng, nét ngoài	outline
sự sản xuất; sản phẩm, sản lượng	output
bề ngoài, bên ngoài; ở ngoài; ngoài	outside
nổi bật, đáng chú ý; còn tồn lại	outstanding
lò (nướng)	oven
bên trên, vượt qua; lên, lên trên	over
toàn bộ, toàn thể; tất cả, bao gồm	overall
thắng, chiến thắng, khắc phục, đánh bại (khó khăn)	overcome
nợ, hàm ơn; có được (cái gì)	owe
của chính mình, tự mình; nhận, nhìn nhận	own
người chủ, chủ nhân	owner
bước chân, bước	pace
gói, bọc; bó, gói	pack
gói đồ, bưu kiện; đóng gói, đóng kiện	package
bao bì	packaging
gói nhỏ	packet
trang (sách)	page
sự đau đớn, sự đau khổ	pain
đau đớn, đau khổ	painful
sơn, vôi màu; sơn, quét sơn	paint
sự sơn; bức họa, bức tranh	painting
họa sĩ	painter
đôi, cặp	pair
cung điện, lâu đài	palace
taí, nhợt	pale
xoong, chảo	pan
ván ô (cửa, tường), pa nô	panel
quần lót, đùi	pants
giấy	paper
song song, tương đương	parallel
cha, mẹ	parent
công viên, vườn hoa; khoanh vùng thành công viên	park
nghi viện, quốc hội	parliament
phần, bộ phận	part
riêng biệt, cá biệt	particular
một cách đặc biệt, cá biệt, riêng biệt	particularly
đến chừng mực nào đó, phần nào đó	partly
đối tác, cộng sự	partner
sự chung phần, sự cộng tác	partnership
tiệc, buổi liên hoan; đảng	party
qua, vượt qua, ngang qua	pass
sự đi qua, sự trôi qua; thoáng qua, ngắn ngủi	passing
sự đi qua, sự trôi qua; hành lang	passage
hành khách	passenger
hộ chiếu	passport
quá khứ, dĩ vãng; quá, qua	past
đường mòn; hướng đi	path
tính kiên nhẫn, nhẫn nại, kiên trì, sự chịu đựng	patience
bệnh nhân; kiên nhẫn, nhẫn nại, bền chí	patient
mẫu, khuôn mẫu	pattern
tạm nghỉ, dừng; sự tạm nghỉ, sự tạm ngừng	pause
trả, thanh toán, nộp; tiền lương	pay
sự trả tiền, số tiền trả, tiền bồi thường	payment
hòa bình, sự hòa thuận	peace
hòa bình, thái bình, yên tĩnh	peaceful
lưỡi trai; đỉnh, chóp	peak
bút	pen
đồng xu	pence
đồng xu	penny
bút chì	pencil
số tiền	penny
tiền trợ cấp, lương hưu	pension
dân tộc, dòng giống; người	people
hạt tiêu, cây ớt	pepper
cho mỗi	per
phần trăm	per
hoàn hảo	perfect
một cách hoàn hảo	perfectly
biểu diễn; làm, thực hiện	perform
sự làm, sự thực hiện, sự thi hành, sự biểu diễn	performance
người biểu diễn, người trình diễn	performer
có thể, có lẽ	perhaps
kỳ, thời kỳ, thời gian; thời đại	period
lâu dài, vĩnh cửu, thường xuyên	permanent
cách thường xuyên, vĩnh cửu	permanently
sự cho phép, giấy phép	permission
cho phép, cho cơ hội	permit
con người, người	person
cá nhân, tư, riêng tư	personal
đích thân, bản thân, về phần rôi, đối với tôi	personally
nhân cách, tính cách; nhân phẩm, cá tính	personality
thuyết phục	persuade
cơn nóng giận; vật cưng, người được yêu thích	pet
xăng dầu	petrol
tuần trăng; giai đoạn, thời kỳ	phase
triết học, triết lý	philosophy
bản sao chụp; sao chụp	photocopy
ảnh, bức ảnh; chụp ảnh	photograph
thợ chụp ảnh, nhà nhiếp ảnh	photographer
thuật chụp ảnh, nghề nhiếp ảnh	photography
câu; thành ngữ, cụm từ	phrase
vật chất; (thuộc) cơ thể, thân thể	physical
về thân thể, theo luật tự nhiên	physically
vật lý học	physics
đàn pianô, dương cầm	piano
cuốc (đất); đào, khoét (lỗ)	pick
bức vẽ, bức họa	picture
mảnh, mẩu; đồng tiền	piece
con lợn	pig
cọc, chồng, đống, pin; đóng cọc, chất chồng	pile
viên thuốc	pill
phi công	pilot
đinh ghim; ghim., kẹp	pin
màu hồng; hoa cẩm chướng, tình trạng tốt, hoàn hảo	pink
Panh (đơn vị (đo lường) ở Anh bằng 0, 58 lít; ở Mỹ bằng 0, 473 lít); panh, lít (bia, sữa) a pint of beer + một panh bia	pint
ống dẫn (khí, nước...)	pipe
sân (chơi các môn thể thao); đầu hắc ín	pitch
lòng thương hại, điều đáng tiếc, đáng thương	pity
nơi, địa điểm; quảng trường	place
ngay thẳng, đơn giản, chất phác	plain
bản đồ, kế hoạch; vẽ bản đồ, lập kế hoạch, dự kiến	plan
sự lập kế hoạch, sự quy hoạch	planning
mặt phẳng, mặt bằng	plane
hành tinh	planet
thực vật, sự mọc lên; trồng, gieo	plant
chất dẻo, làm bằng chất dẻo	plastic
bản, tấm kim loại	plate
nền, bục, bệ; thềm, sân ga	platform
chơi, đánh; sự vui chơi, trò chơi, trận đấu	play
người chơi 1 trò chơi nào đó (nhạc cụ)	player
vui vẻ, dễ thương; dịu dàng, thân mật	pleasant
vui vẻ, dễ thương; thân mật	pleasantly
không dễ chịu, khó chịu, khó ưa	unpleasant
làm vui lòng, vừa lòng, mong... vui lòng, xin mời	please
mang lại niềm vui thích; dễ chịu	pleasing
hài lòng	pleased
niềm vui thích, điều thích thú, điều thú vị; ý muốn, ý thích	pleasure
nhiều (s.k.lượng); chỉ sự thừa; sự sung túc, sự p.phú	plenty
mảnh đất nhở, sơ đồ, đồ thị, đồ án; vẽ sơ đồ, dựng đồ án	plot
nút (thùng, chậu, bồn...)	plug
cộng với (số, người...); dấu cộng; cộng, thêm vào	plus
quá trưa, chiều, tối	p.m.
túi (quần áo, trong xe hơi), túi tiền	pocket
bài thơ	poem
thi ca; chất thơ	poetry
point mũi nhọn, điểm; vót, làm nhọn, chấm (câu..)	point
nhọn, có đầu nhọn	pointed
chất độc, thuốc độc; đánh thuốc độc, tẩm thuốc độc	poison
độc, có chất độc, gây chết, bệnh	poisonous
người Ba Lan; cực (nam châm, trái đất...)	pole
cảnh sát, công an	police
chính sách	policy
nước bóng, nước láng; đánh bóng, làm cho láng	polish
lễ phép, lịch sự	polite
lễ phép, lịch sự	politely
về chính trị, về chính phủ, có tính chính trị	political
về mặt chính trị; khôn ngoan, thận trọng; sảo quyệt	politically
nhà chính trị, chính khách	politician
họat động chính trị, đời sống chính trị, quan điểm chính trị	politics
sự ô nhiễm	pollution
vũng nước; bể bơi, hồ bơi	pool
nghèo	poor
tiếp bốp, phong cách dân gian hiện đại; nổ bốp	pop
có tính đại chúng, (thuộc) nhân dân; được nhiều người ưa chuộng	popular
dân cư, dân số; mật độ dân số	population
cảng	port
đưa ra, đề ra, đặt; sự đặt, đề ra	pose
vị trí, chỗ	position
xác thực, rõ ràng, tích cực, lạc quan	positive
có, chiếm hữu	possess
quyền sở hữu, vật sở hữu	possession
khă năng, triển vọng	possibility
có thể, có thể thực hiện	possible
có lẽ, có thể, có thể chấp nhận được	possibly
thư, bưu kiện; gửi thư	post
bưu điện	post
can, bình, lọ...	pot
khoai tây	potato
tiềm năng; khả năng, tiềm lực	potential
tiềm năng, tiềm ẩn	potentially
pao - đơn vị đo lường	pound
rót, đổ, giội	pour
bột, bụi	powder
khả năng, tài năng, năng lực; sức mạnh, nội lực; quyền lực	power
hùng mạnh, hùng cường	powerful
thực hành; thực tế	practical
về mặt thực hành; thực tế	practically
thực hành, thực tiễn	practice
thực hành, tập luyện	practise
sự ca ngợi, sự tán dương, lòng tôn kính, tôn thờ; khen ngợi, tán dương	praise
sự cầu nguyện	prayer
rõ ràng, chính xác; tỉ mỉ, kỹ tính	precise
đúng, chính xác, cần thận	precisely
báo trước, tiên đoán, dự báo	predict
thích hơn	prefer
sự thích hơn, sự ưa hơn; cái được ưa thích hơn	preference
mang thai; giàu trí tưởng tượng, sáng tạo	pregnant
biệt thự	premises
sự sửa soạn, sự chuẩn bị	preparation
sửa soạn, chuẩn bị	prepare
đã được chuẩn bị	prepared
sự hiện diện, sự có mặt; người, vât hiện diện	presence
and /(n)'prezәnt/ có mặt, hiện diện; hiện nay, hiện thời; bày tỏ, giới thiệu, trình bày	present
bài thuyết trình, sự trình diện, sự giới thiệu	presentation
bảo quản, giữ gìn	preserve
hiệu trưởng, chủ tịnh, tổng thống	president
sự ép, sự nén, sự ấn; ép, nén, bóp, ấn	press
sức ép, áp lực, áp suất	pressure
có thể được, có lẽ	presumably
giả vờ, giả bộ, làm ra vẻ	pretend
khá, vừa phải; xinh, xinh xắn;, đẹp	pretty
ngăn cản, ngăn chặn, ngăn ngừa	prevent
vội vàng, hấp tấp; trước (vd. ngày hôm trước), ưu tiên	previous
trước, trước đây	previously
giá	price
sự kiêu hãnh, sự hãnh diện; tính kiêu căng, tự phụ	pride
linh mục, thầy tu	priest
nguyên thủy, đầu tiên; thời cổ đại, nguyên sinh; sơ cấp, tiểu học	primary
trước hết, đầu tiên	primarily
thủ tướng	prime
hoành tử	prince
công chúa	princess
cơ bản, chủ yếu; nguyên lý, nguyên tắc	principle
in, xuất bản; sự in ra	print
sự in, thuật in, kỹ sảo in	printing
máy in, thợ in	printer
trước, ưu tiên	prior
sự ưu tế, quyền ưu tiên	priority
nhà tù	prison
tù nhân	prisoner
cá nhân, riêng	private
riêng tư, cá nhân	privately
giải, giải thưởng	prize
có thể, có khả năng	probable
hầu như chắc chắn	probably
vấn đề, điều khó giải quyết	problem
thủ tục	procedure
tiến lên, theo duổi, tiếp diễn	proceed
quá trình, sự tiến triển, quy trình; chế biến, gia công, xử lý	process
sản xuất, chế tạo	produce
nhà sản xuất	producer
sản phẩm	product
sự sản xuất, chế tạo	production
nghề, nghề nghiệp	profession
(thuộc) nghề, nghề nghiệp; chuyên nghiệp	professional
giáo sư, giảng viên	professor
thuận lợi, lợi ích, lợi nhuận	profit
chương trình; lên chương trình	program
chương trình	programme
sự tiến tới, sự tiến triển; tiến bộ, tiến triển, phát triển	progress
đề án, dự án, kế hoạch; dự kiến, kế hoạch	project
hứa, lời hứa	promise
thăng chức, thăng cấp	promote
sự thăng chức, sự thăng cấp	promotion
mau lẹ, nhanh chóng; xúi, giục, nhắc nhở	prompt
mau lẹ, ngay lập tức	promptly
tuyên bố, thông báo, phát âm	pronounce
sự phát âm	pronunciation
chứng, chứng cớ, bằng chứng; sự kiểm chứng	proof
đúng, thích đáng, thích hợp	proper
một cách đúng đắn, một cách thích đáng	properly
tài sản, của cải; đất đai, nhà cửa, bất động sản	property
sự cân xứng, sự cân đối	proportion
sự đề nghị, đề xuất	proposal
đề nghị, đề xuất, đưa ra	propose
viễn cảnh, toàn cảnh; triển vọng, mong chờ	prospect
bảo vệ, che chở	protect
sự bảo vệ, sự che chở	protection
sự phản đối, sự phản kháng; phản đối, phản kháng	protest
tự hào, kiêu hãnh	proud
một cách tự hào, một cách hãnh diện	proudly
chứng tỏ, chứng minh	prove
chuẩn bị đầy đủ, dự phòng; cung cấp, chu cấp	provide
với điều kiện là, miễn là	provided
panh (= 0, 58 lít (E);=0, 473 lít (A));	pint
= publicyhouse quán rượu, tiệm rượu	pub
chung, công cộng; công chúng, nhân dân	public
công khai, công cộng	publicly
sự công bố; sự xuất bản	publication
sự công khai, sự quảng cáo	publicity
công bố, ban bố; xuất bản	publish
công việc, nghề xuất bản	publishing
lôi, kéo, giật; sự lôi kéo, sự giật	pull
đấm, thụi; quả đấm, cú thụi	punch
phạt, trừng phạt	punish
sự trừng phạt, sự trừng trị	punishment
học sinh	pupil
sự mua, sự tậu; mua, sắm, tậu	purchase
nguyên chất, tinh khiết, trong lành	pure
hoàn toàn, chỉ là	purely
tía, có màu tía; màu tía	purple
mục đích, ý định	purpose
đuổi theo, đuổi bắt	pursue
xô đẩy; sự xô đẩy	push
đặt, để, cho vào	put
phẩm chất, năng lực; khả năng chuyên môn	qualification
đủ khả năng, đủ tư cách, điều kiện	qualify
đủ tư cách, điều kiện, khả năng	qualified
chất lượng, phẩm chất	quality
lượng, số lượng	quantity
1/4, 15 phút	quarter
nữ hoàng	queen
câu hỏi; hỏi, chất vấn	question
nhanh	quick
nhanh	quickly
lặng, yên lặng, yên tĩnh	quiet
lặng, yên lặng, yên tĩnh	quietly
thoát, thoát ra	quit
hoàn toàn, hầu hết	quite
trích dẫn	quote
loài, chủng, giống; cuộc đua; đua	race
cuộc đua	racing
sóng vô tuyến, radio	radio
đường ray	rail
đường sắt	railway
mưa, cơn mưa; mưa	rain
nâng lên, đưa lên, ngẩng lên	raise
dãy, hàng, loại; phạm vi, trình độ	range
hàng, dãy; sắp xếp thành hàng, dãy	rank
nhanh, nhanh chóng	rapid
nhanh, nhanh chóng	rapidly
hiếm, ít	rare
hiếm khi, ít khi	rarely
tỷ lệ, tốc độ	rate
thà.. còn hơn, thích... hơn	rather
sống (# chín), thô, còn nguyên chất	raw
đến, đi đến, tới	reach
tác động trở lại, phản ứng	react
sự phản ứng; sự phản tác dụng	reaction
đọc	read
sự đọc	reading
người đọc, độc giả	reader
sẵn sàng	ready
thực, thực tế, có thật	real
thực, thực ra, thực sự	really
hiện thực	realistic
sự thật, thực tế, thực tại	reality
thực hiện, thực hành	realize
phía sau; ở đằng sau, ở đằng sau	rear
lý do, lý lẽ	reason
có lý, hợp lý	reasonable
hợp lý	reasonably
vô lý	unreasonable
gọi về, triệu hồi; nhặc lại, gợi lại	recall
công thức; đơn thuốc	receipt
nhận, lĩnh, thu	receive
gần đây, mới đây	recent
gần đây, mới đây	recently
sự nhận, sự tiếp nhận, sự đón tiếp	reception
tính, đếm	reckon
sự công nhận, sự thừa nhận	recognition
nhận ra, nhận diện; công nhận, thừa nhận	recognize
giới thiệu, tiến cử; đề nghị, khuyên bảo	recommend
bản ghi, sự ghi, bản thu, sự thu; thu, ghi chép	record
sự ghi, sự thu âm	recording
lấy lại, giành lại	recover
đỏ; màu đỏ	red
giảm, giảm bớt	reduce
sự giảm giá, sự hạ giá	reduction
xem, tham khảo; ám chỉ, nhắc đến	refer
sự tham khảo, hỏi ýe kiến	reference
phản chiếu, phản hồi, phản ánh	reflect
cải cách, cải thiện, cải tạo; sự cải cách, sự cải thiện, cải tạo	reform
tủ lạnh	refrigerator
sự từ chối, sự khước từ	refusal
từ chối, khước từ	refuse
nhìn, đánh giá; cái nhìn, sự quan tâm, sự chú ý (lời chúc tụng cuối thư)	regard
về, về việc, đối với (vấn đề...)	regarding
vùng, miền	region
vùng, địa phương	regional
đăng ký, ghi vào sổ; sổ, sổ sách, máy ghi	register
đáng tiếc, hối tiếc; lòng thương tiếc, sự hối tiếc	regret
thường xuyên, đều đặn	regular
đều đặn, thường xuyên	regularly
sự điều chỉnh, điều lệ, quy tắc	regulation
không chấp nhận, loại bỏ, bác bỏ	reject
kể lại, thuật lại; liên hệ, liên quan	relate
có liên quan, có quan hệ với ai, cái gì	related
mối quan hệ, sự liên quan, liên lạc	relation
mối quan hệ, mối liên lạc	relationship
có liên quan đến; người có họ, đại từ quan hệ	relative
có liên quan, có quan hệ	relatively
giải trí, nghỉ ngơi	relax
thanh thản, thoải mái	relaxed
làm giảm, bớt căng thẳng	relaxing
làm nhẹ, bớt, thả, phóng thích, phát hành; sự giải thoát, thoát khỏi, sự thả, phóng thích, sự phát hành	release
thích hợp, có liên quan	relevant
sự giảm nhẹ, sự làm cho khuây khỏa; sự trợ cấo; sự đền bù	relief
tôn giáo	religion
(thuộc) tôn giáo	religious
tin vào, tin cậy, tin tưởng vào	rely
còn lại, vẫn còn như cũ	remain
còn lại	remaining
đồ thừa, cái còn lại	remains
sự nhận xét, phê bình, sự để ý, chú ý; nhận xét, phê bình, để ý, chú ý	remark
đáng chú ý, đáng để ý; khác thường	remarkable
đáng chú ý, đáng để ý; khác thường	remarkably
nhớ, nhớ lại	remember
nhắc nhở, gợi nhớ	remind
xa, xa xôi, xa cách	remote
viêc di chuyển, việc dọn nhà, dời đi	removal
dời đi, di chuyển	remove
sự thuê mướn; cho thuê, thuê	rent
được thuê, được mướn	rented
sửa chữa, chỉnh tu; sự sửa chữa, sự chỉnh tu	repair
/ri'pi:t/ nhắc lại, lặp lại	repeat
được nhắc lại, được lặp lại	repeated
lặp đi lặp lại nhiều lần	repeatedly
thay thế	replace
sự trả lời, sự hồi âm; trả lời, hồi âm	reply
báo cáo, tường trình; bản báo cáo, bản tường trình	report
miêu tả, hình dung; đại diện, thay mặt	represent
điều tiêu biểu, tượng trưng, mẫu; miêu tả, biểu hiện, đại diện, tượng trưng	representative
tái sản xuất	reproduce
sự nổi tiếng, nổi danh	reputation
lời thỉnh cầu, lời đề nghị, yêu cầu; thỉnh cầu, đề nghị, yêu cầu	request
đòi hỏi, yêu cầu, quy định	require
nhu cầu, sự đòi hỏi; luật lệ, thủ tục	requirement
giải thoát, cứu nguy; sự giải thoát, sự cứu nguy	rescue
sự nghiên cứu	research
sự hạn chế, điều kiện hạn chế	reservation
dự trữ, để dành, đặt trước, đăng ký trước; sự dự trữ, sự để dành, sự đặt trước, sự đăng ký trước	reserve
người sinh sống, trú ngụ, khách trọ; có nhà ở, cư trú, thường trú	resident
chống lại, phản đổi, kháng cự	resist
sự chống lại, sự phản đối, sự kháng cự	resistance
quyết định, kiên quyết (làm gì); giải quyết (vấn đề, khó khăn..)	resolve
kế sách, phương kế	resort
tài nguyên; kế sách, thủ đoạn	resource
sự kính trọng, sự lễ phép; tôn trọng, kính trọng, khâm phục	respect
hưởng ứng, phản ứng lại, trả lời	respond
sự trả lời, câu trả lời, sự hưởng ứng, sự đáp lại	response
trách nhiệm, sự chịu trách nhiệm	responsibility
chịu trách nhiệm về, chịu trách nhiệm trước ai, gì	responsible
sự nghỉ ngơi, lúc nghỉ; nghỉ, nghỉ ngơi	rest
nhà hàng ăn, hiệu ăn	restaurant
hoàn lại, trả lại; sửa chữa lại, phục hồi lại	restore
hạn chế, giới hạn	restrict
bị hạn chế, có giới hạn; vùng cấm	restricted
sự hạn chế, sự giới hạn	restriction
kết quả; bởi, do.. mà ra, kết quả là...	result
giữ lại, nhớ được	retain
rời bỏ, rút về; thôi, nghỉ việc, về hưu	retire
ẩn dật, hẻo lánh, đã về hưu, đã nghỉ việc	retired
sự ẩn dật, nơi hẻo lánh, sự về hưu, sự nghỉ việc	retirement
trở lại, trở về; sự trở lại, sự trở về	return
bộc lộ, biểu lộ, tiết lộ; phát hiện, khám phá	reveal
đảo, ngược lại; điều trái ngược, mặt trái	reverse
sự xem lại, sự xét lại; làm lại, xem xét lại	review
đọc lại, xem lại, sửa lại, ôn lại	revise
sự xem lại, sự đọc lại, sự sửa lại, sự ôn lại	revision
cuộc cách mạng	revolution
sự thưởng, phần thưởng; thưởng, thưởng công	reward
nhịp điệu	rhythm
gạo, thóc, cơm; cây lúa	rice
giàu, giàu có	rich
giải thoát (get rid of : tống khứ)	rid
đi, cưỡi (ngựa); sự đi, đường đi	ride
môn thể thao cưỡi ngựa, sự đi xe (bus, điện, xe đạp)	riding
người cưỡi ngựa, người đi xe đạp	rider
buồn cười, lố bịch, lố lăng	ridiculous
thẳng, phải, tốt; ngay, đúng; điều thiện, điều phải, tốt, bên phải	right
đúng, phải, có lý	rightly
chiếc nhẫn, đeo nhẫn cho ai	ring
sự lên, sự tăng lương, thăng cấp; dậy, đứng lên, mọc (mặt trời), thành đạt	rise
sự liều, mạo hiểm; liều	risk
đối thủ, địch thủ; đối địch, cạnh tranh	rival
sông	river
con đường, đường phố	road
cướp, lấy trộm	rob
đá	rock
vai (diễn), vai trò	role
cuốn, cuộn, sự lăn tròn; lăn, cuốn, quấn, cuộn	roll
lãng mạn	romantic
mái nhà, nóc	roof
phòng, buồng	room
gốc, rễ	root
dây cáp, dây thừng, xâu, chuỗi	rope
gồ ghề, lởm chởm	rough
gồ ghề, lởm chởm	roughly
tròn, vòng quanh, xung quanh	round
bị làm thành tròn; phát triển đầy đủ	rounded
đường đi, lộ trình, tuyến đường	route
thói thường, lệ thường, thủ tục; thường lệ, thông thường	routine
hàng, dãy	row
(thuộc) vua, nữ hoàng, hoàng gia	royal
cọ xát, xoa bóp, nghiền, tán	rub
cao su	rubber
vật vô giá trị, bỏ đi, rác rưởi	rubbish
bất lịch sự, thô lỗ; thô sơ, đơn giản	rude
bất lịch sự, thô lỗ; thô sơ, đơn giản	rudely
làm hỏng, làm đổ nát, làm phá sản; sự hỏng, sự đổ nát, sự phá sản	ruin
bị hỏng, bị đổ nát, bị phá sản	ruined
quy tắc, điều lệ, luật lệ; cai trị, chỉ huy, điều khiển	rule
người cai trị, người trị vì; thước kẻ	ruler
tin đồn, lời đồn	rumour
chạy; sự chạy	run
sự chạy, cuộc chạy đua	running
người chạy	runner
(thuộc) nông thôn, vùng nông thôn	rural
xông lên, lao vào, xô đẩy; sự xông lên, sự lao vào, sự xô đẩy	rush
bào tải; đóng bao, bỏ vào bao	sack
buồn, buồn bã	sad
một cách buồn bã, đáng buồn là, không may mà	sadly
sự buồn rầu, sự buồn bã	sadness
an toàn, chắc chắn, đáng tin	safe
an toàn, chắc chắn, đáng tin	safely
sự an toàn, sự chắc chăn	safety
đi tàu, thuyền, nhổ neo; buồm, cánh buồm, chuyến đi bằng thuyền buồm	sail
sự đi thuyền	sailing
thủy thủ	sailor
sa lát (xà lách trộng dầu dấm); rau sống	salad
tiền lương	salary
việc bán hàng	sale
muối	salt
chứ vị muối, có muối, mặn	salty
đều đều, đơn điệu; cũng như thế, vẫn cái đó	same
mẫu, hàng mẫu	sample
cát	sand
sự làm cho thỏa mãn, toại nguyện; sự trả nợ, bồi thường	satisfaction
làm thỏa mãn, hài lòng; trả (nợ), chuộc tội	satisfy
cảm thấy hài lòng, vừa ý, thoả mãn	satisfied
đem lại sự thỏa mãn, làm thỏa mãn, làm vừa ý	satisfying
thứ 7	Saturday
nước xốt, nước chấm	sauce
cứu, lưu	save
sự cứu, sự tiết kiệm	saving
nói	say
vảy (cá..)	scale
làm kinh hãi, sợ hãi, dọa; sự sợ hãi, sự kinh hoàng	scare
bị hoảng sợ, bị sợ hãi	scared
cảnh, phong cảnh	scene
kế hoạch làm việc, bản liệt kê; lên thời khóa biểu, lên kế hoạch	schedule
sự sắp xếp, sự phối hợp; kế hoạch thực hiện; lược đồ, sơ đồ	scheme
đàn cá, bầy cá	school
khoa học, khoa học tự nhiên	science
(thuộc) khoa học, có tính khoa học	scientific
nhà khoa học	scientist
cái kéo	scissors
điểm số, bản thắng, tỷ số; đạt được, thành công, cho điểm	score
cào, làm xước da; sự cào, sự trầy xước da	scratch
gào thét, kêu lên; tiếng thét, tiếng kêu to	scream
màn che, màn ảnh, màn hình; phim ảnh nói chung	screen
đinh vít, đinh ốc; bắt vít, bắt ốc	screw
biển	sea
hải cẩu; săn hải cẩu	seal
sự tìm kiếm, sự thăm dò, sự điều tra; tìm kiếm, thăm dò, điều tra	search
mùa	season
ghế, chỗ ngồi	seat
thứ hai, ở vị trí thứ 2, thứ nhì; người về nhì	second
trung học, thứ yếu	secondary
bí mật; điều bí mật	secret
bí mật, riêng tư	secretly
thư ký	secretary
mục, phần	section
khu vực, lĩnh vực	sector
chắc chắn, đảm bảo; bảo đảm, giữ an ninh	secure
sự an toàn, sự an ninh	security
nhìn, nhìn thấy, quan sát	see
hạt, hạt giống	seed
tìm, tìm kiếm, theo đuổi	seek
có vẻ như, dường như	seem
chọn lựa, chọn lọc	select
sự lựa chọn, sự chọc lọc	selection
bản thân mình	self
bán	sell
thượng nghi viện, ban giám hiệu	senate
thượng nghị sĩ	senator
gửi, phái đi	send
nhiều tuổi hơn, dành cho trẻ em trên 11t; người lớn tuổi hơn, sinh viên năm cuối trường trung học, cao đẳng	senior
giác quan, tri giác, cảm giác	sense
có óc xét đoán; hiểu, nhận biết được	sensible
dễ bị thương, dễ bị hỏng; dễ bị xúc phạm	sensitive
câu	sentence
khác nhau, riêng biệt; làm rời, tách ra, chia tay	separate
ly thân	separated
không cùng nhau, thành người riêng, vật riêng	separately
sự chia cắt, phân ly, sự chia tay, ly thân	separation
tháng 9	September
loạt, dãy, chuỗi	series
đứng đắn, nghiêm trang	serious
đứng đắn, nghiêm trang	seriously
người hầu, đầy tớ	servant
phục vụ, phụng sự	serve
sự phục vụ, sự hầu hạ	service
buổi họp, phiên họp, buổi, phiên	session
bộ, bọn, đám, lũ; đặt để, bố trí	set
giải quyết, dàn xếp, hòa giải, đặt, bố trí	settle
vài	several
khắt khe, gay gắt (thái độ, cư xử); giản dị, mộc mạc (kiểu cách, trang phục, dung nhan)	severe
khắt khe, gay gắt (thái độ, cư xử); giản dị, mộc mạc (kiểu cách, trang phục, dung nhan)	severely
may, khâu	sew
sự khâu, sự may vá	sewing
giới, giống	sex
giới tính, các vấn đề sinh lý	sexual
giới tính, các vấn đề sinh lý	sexually
bóng, bóng tối	shade
bóng, bóng tối, bóng râm, bóng mát	shadow
rung, lắc, giũ; sự rung, sự lắc, sự giũ	shake
dự đoán tương lai: sẽ	shall
nông, cạn	shallow
sự xấu hổ, thẹn thùng, sự ngượng	shame
hình, hình dạng, hình thù	shape
có hình dáng được chỉ rõ	shaped
đóng góp, tham gia, chia sẻ; phần đóng góp, phần tham gia, phần chia sẻ	share
sắc, nhọn, bén	sharp
sắc, nhọn, bén	sharply
cạo (râu), bào, đẽo (gỗ)	shave
nó, bà ấy, chị ấy, cô ấy...	she
con cừu	sheep
chăn, khăn trải giường; lá, tấm, phiến, tờ	sheet
kệ, ngăn, giá	shelf
vỏ, mai; vẻ bề ngoài	shell
sự nương tựa, sự che chở, sự ẩn náu; che chở, bảo vệ	shelter
đổi chỗ, dời chỗ, chuyển, giao; sự thay đổi, sự luân phiên	shift
chiếu sáng, tỏa sáng	shine
sáng chói, bóng	shiny
tàu, tàu thủy	ship
áo sơ mi	shirt
sự đụng chạm, va chạm, sự kích động, sự choáng; chạm mạnh, va mạnh, gây sốc	shock
gây ra căm phẫn, tồi tệ, gây kích động	shocking
bị kích động, bị va chạm, bị sốc	shocked
giày	shoe
vụt qua, chạy qua, ném, phóng, bắn; đâm ra, trồi ra	shoot
sự bắn, sự phóng đi	shooting
cửa hàng; đi mua hầng, đi chợ	shop
sự mua sắm	shopping
ngắn, cụt	short
trong thời gian ngắn, sớm	shortly
đạn, viên đạn	shot
nên	should
vai	shoulder
hò hét, reo hò; sự la hét, sự hò reo	shout
biểu diễn, trưng bày; sự biểu diễn, sự bày tỏ	show
vòi hoa sen, sự tắm vòi hoa sen	shower
đóng, khép, đậy; tính khép kín	shut
nhút nhát, e thẹn	shy
ốm, đau, bệnh	sick
mặt, mặt phẳng	side
ngang, từ một bên; sang bên	sideways
cảnh đẹp; sự nhìn	sight
dấu, dấu hiệu, kí hiệu; đánh dấu, viết ký hiệu	sign
dấu hiệu, tín hiệu; ra hiệu, báo hiệu	signal
chữ ký	signature
nhiều ý nghĩa, quan trọng	significant
đáng kể	significantly
sự im lặng, sự yên tĩnh	silence
im lặng, yên tĩnh	silent
tơ (t.n+n.tạo), chỉ, lụa	silk
ngớ ngẩn, ngu ngốc, khờ dại	silly
bạc, đồng bạc; làm bằng bạc, trắng như bạc	silver
giống như, tương tự như	similar
tương tự, giống nhau	similarly
đơn, đơn giản, dễ dàng	simple
một cách dễ dàng, giản dị	simply
từ, từ khi; từ khi, từ lúc đó; từ đó, từ lúc ấy	since
thật thà, thẳng thắng, chân thành	sincere
một cách chân thành	sincerely
(viết ở cuối thư)	Yours
hát, ca hát	sing
sự hát, tiếng hát	singing
ca sĩ	singer
đơn, đơn độc, đơn lẻ	single
chìm, lún, đắm	sink
xưng hô lịch sự Ngài, Ông	sir
chị, em gái	sister
ngồi	sit
chỗ, vị trí	site
hoàn cảnh, địa thế, vị trí	situation
cỡ	size
đã được định cỡ	-sized
tài giỏi, khéo tay	skilful
tài giỏi, khéo tay	skilfully
kỹ năng, kỹ sảo	skill
có kỹ năng, có kỹ sảo, khẻo tay; có kinh nghiệm,, lành nghề	skilled
da, vỏ	skin
váy, đầm	skirt
trời, bầu trời	sky
ngủ; giấc ngủ	sleep
tay áo, ống tay	sleeve
miếng, lát mỏng; cắt ra thành miếng mỏng, lát mỏng	slice
trượtc, chuyển động nhẹ, lướt qua	slide
mỏng manh, thon, gầy	slight
mảnh khảnh, mỏng manh, yếu ớt	slightly
trượt, tuột, trôi qua, chạy qua	slip
dốc, đường dốc, độ dốc; nghiêng, dốc	slope
chậm, chậm chạp	slow
một cách chậm chạp, chậm dần	slowly
nhỏ, bé	small
mạnh, ác liệt	smart
đập, vỡ tan thành mảnh; sự đập, vỡ tàn thành mảnh	smash
ngửi; sự ngửi, khứu giác	smell
cười, mỉm cười; nụ cười, vẻ tươi cười	smile
khói, hơi thuốc; hút thuốc, bốc khói, hơi	smoke
sự hút thuốc	smoking
nhẵn, trơn, mượt mà	smooth
một cách êm ả, trôi chảy	smoothly
con rắn; người nham hiểm, xảo trá	snake
tuyết; tuyết rơi	snow
như vậy, như thế; vì thế, vì vậy, vì thế cho nên	so
xà phòng	soap
có tính xã hội	social
có tính xã hội	socially
xã hội	society
tất ngăns, miếng lót giày	sock
mềm, dẻo	soft
một cách mềm dẻo	softly
phần mềm (m.tính)	software
đất trồng; vết bẩn	soil
lính, quân nhân	soldier
rắn; thể rắn, chất rắnh	solid
sự giải quyết, giải pháp	solution
giải, giải thích, giải quyết	solve
or /səm/ một it, một vài	some
người nào đó	somebody
không biết làm sao, bằng cách này hay cách khác	somehow
một điều gì đó, một việc gì đó, một cái gì đó	something
thỉnh thoảng, đôi khi	sometimes
đến mức độ nào đó, hơi, một chút	somewhat
nơi nào đó. đâu đó	somewhere
con trai	son
bài hát	song
sớm, chẳng bao lâu nữa	soon
đau, nhức	sore
xin lỗi, lấy làm tiếc, lấy làm buồn	sorry
thứ, hạng loại; lựa chọn, sắp xếp, phân loại	sort
tâm hồn, tâm trí, linh hồn	soul
âm thanh; nghe	sound
xúp, canh, cháo	soup
chua, có vị giấm	sour
nguồn	source
phương Nam, hướng Nam; ở phía Nam; hướng về phía Nam	south
thuộc phương Nam	southern
khoảng trống, khoảng cách	space
thừa thãi, dự trữ, rộng rãi; đồ dự trữ, đồ dự phòng	spare
nói	speak
nói theo 1 cách nào đó	spoken
người nói, người diễn thuyết	speaker
đặc biệt, riêng biệt	special
đặc biệt, riêng biệt	specially
chuyên gia, chuyên viên	specialist
đặc trưng, riêng biệt	specific
đặc trưng, riêng biệt	specifically
sự nói, khả năng nói, lời nói, cách nói, bài nói	speech
tốc độ, vận tốc	speed
đánh vần; sự thu hút, sự quyến rũ, say mê	spell
sự viết chính tả	spelling
tiêu, xài	spend
gia vị	spice
có gia vị	spicy
con nhện	spider
quay, quay tròn	spin
tinh thần, tâm hồn, linh hồn	spirit
(thuộc) tinh thần, linh hồn	spiritual
sự giận, sự hận thù; in spite of : mặc dù, bất chấp	spite
chẻ, tách, chia ra; sự chẻ, sự tách, sự chia ra	split
cướp, cướp đọat	spoil
cái thìa	spoon
thể thao	sport
dấu, đốm, vết	spot
máy, ống, bình phụt, bơm, phun; bơm, phun, xịt	spray
trải, căng ra, bày ra; truyền bá	spread
mùa xuân	spring
vuông, vuông vắn; dạng hình vuông, hình vuông	square
ép, vắt, xiết; sự ép, sự vắt, sự xiết	squeeze
ổn định, bình tĩnh, vững vàng; chuồng ngưa	stable
gậy	staff
tầng, bệ	stage
bậc thang	stair
tem; dán tem	stamp
đứng, sự đứng	stand
tiêu chuẩn, chuẩn, mãu; làm tiêu chuẩn, phù hợp với tiêu chuẩn	standard
ngôi sao, dán sao, trang trí hình sao, đánh dấu sao	star
nhìm chằm chằm; sự nhìn chằm chằm	stare
bắt đầu, khởi động; sự bắt đầu, sự khởi đầu, khởi hành	start
nhà nước, quốc gia, chính quyền; (thuộc) nhà nước, có liên quan đến nhà nước; phát biểu, tuyên bố	state
sự bày tỏ, sự phát biểu; sự tuyên bố, sự trình bày	statement
trạm, điểm, đồn	station
tượng	statue
tình trạng	status
ở lại, lưu lại; sự ở lại, sự lưu lại	stay
vững chắc, vững vàng, kiến định	steady
vững chắc, vững vàng, kiên định	steadily
không chắc, không ổn định	unsteady
ăn cắp, ăn trộm	steal
hơi nước	steam
thép, ngành thép	steel
dốc, dốc đứng	steep
dốc, cheo leo	steeply
lái (tàu, ô tô...)	steer
bước; bước, bước đi	step
đâm, thọc, chọc, cắm, dính; cái gậy, qua củi, cán	stick
dính, nhớt	sticky
cứng, cứng rắn, kiên quyết	stiff
cứng, cứng rắn, kiên quyết	stiffly
đứng yên; vẫn, vẫn còn	still
châm, chích, đốt; ngòi, vòi (ong, muỗi), nọc (rắn); sự châm, chích..	sting
khuấy, đảo	stir
kho sự trữ, hàng dự trữ, vốn	stock
dạ dày	stomach
đá	stone
dừng, ngừng, nghỉ, thôi; sự dừng, sự ngừng, sự đỗ lại	stop
cửa hàng, kho hàng; tích trữ, cho vào kho	store
cơn giông, bão	storm
chuyện, câu chuyện	story
bếp lò, lò sưởi	stove
thẳng, không cong	straight
sự căng thẳng, sự căng	strain
xa lạ, chưa quen	strange
lạ, xa lạ, chưa quen	strangely
người lạ	stranger
chiến lược	strategy
dòng suối	stream
phố, đườmg phố	street
sức mạnh, sức khỏe	strength
sự căng thẳng; căng thẳng, ép, làm căng	stress
bị căng thẳng, bị ép, bị căng	stressed
căng ra, duỗi ra, kéo dài ra	stretch
nghiêm khắc, chặt chẽ,, khắt khe	strict
một cách nghiêm khắc	strictly
đánh, đập, bãi công, đình công; cuộc bãi công, cuộc đình công	strike
nổi bật, gây ấn tượng	striking
dây, sợi dây	string
cởi, lột (quần áo); sự cởi quần áo	strip
sọc, vằn, viền	stripe
có sọc, có vằn	striped
cú đánh, cú đòn; cái vuốt ve, sự vuốt ve; vuốt ve	stroke
khỏe, mạnh, bền, vững, chắc chắn	strong
khỏe, chắc chắn	strongly
kết cấu, cấu trúc	structure
đấu tranh; cuộc đấu tranh, cuộc chiến đấu	struggle
sinh viên	student
xưởng phim, trường quay; phòng thu	studio
sự học tập, sự nghiên cứu; học tập, nghiên cứu	study
chất liệu, chất	stuff
ngu ngốc, ngu đần, ngớ ngẩn	stupid
phong cách, kiểu, mẫu, loại	style
chủ đề, đề tài; chủ ngữ	subject
chất liệu; bản chất; nội dung	substance
thực tế, đáng kể, quan trọng	substantial
về thực chất, về căn bản	substantially
người, vật thay thế; thay thế	substitute
nối tiếp, kế tiếp; kế nghiệp, kế vị	succeed
sự thành công,, sự thành đạt	success
thành công, thắng lợi, thành đạt	successful
thành công, thắng lợi, thành đạt	successfully
không thành công, thất bại	unsuccessful
như thế, như vậy, như là	such
bú, hút; hấp thụ, tiếp thu	suck
thình lình, đột ngột	sudden
thình lình, đột ngột	suddenly
chịu đựng, chịu thiệt hại, đau khổ	suffer
sự đau đớn, sự đau khổ	suffering
(+ for) đủ, thích đáng	sufficient
đủ, thích đáng	sufficiently
đường	sugar
đề nghị, đề xuất; gợi	suggest
sự đề nghị, sự đề xuất, sự khêu gợi	suggestion
bộ com lê, trang phục; thích hợp, quen, hợp với	suit
hợp, phù hợp, thích hợp với	suited
hợp, phù hợp, thích hợp với	suitable
va li	suitcase
tổng, toàn bộ	sum
bản tóm tắt	summary
mùa hè	summer
mặt trời	sun
Chủ nhật	Sunday
cao, chất lượng cao	superior
siêu thị	supermarket
sự cung cấp, nguồn cung cấp; cung cấp, đáp ứng, tiếp tế	supply
sự chống đỡ, sự ủng hộ; chống đỡ, ủng hộ	support
vật chống đỡ; người cổ vũ, người ủng hộ	supporter
cho rằng, tin rằng, nghĩ rằng	suppose
chắc chắn, xác thực	sure
chắc chắn	surely
mặt, bề mặt	surface
họ	surname
sự ngạc nhiên, sự bất ngờ; làm ngạc nhiên, gây bất ngờ	surprise
làm ngạc nhiên, làm bất ngờ	surprising
làm ngạc nhiên, làm bất ngờ	surprisingly
ngạc nhiên (+ at)	surprised
vây quanh, bao quanh	surround
sự vây quanh, sự bao quanh	surrounding
vùng xung quanh, môi trường xung quanh	surroundings
sự nhìn chung, sự khảo sát; quan sát, nhìn chung, khảo sát, nghiên cứu	survey
sống lâu hơn, tiếp tục sống, sống sót	survive
nghi ngờ, hoài nghi; người khả nghi, người bị tình nghi	suspect
sự nghi ngờ, sự ngờ vực	suspicion
có sự nghi ngờ, tỏ ra nghi ngờ, khả nghi	suspicious
nuốt, nuốt chửng	swallow
chửi rủa, nguyền rủa; thề, hứa	swear
lời thề, lời nguyền rủa, lời thề hứa	swearing
mồ hôi; đổ mồ hôi	sweat
người ra mồ hôi,, kẻ bóc lột lao động	sweater
quét	sweep
ngọt, có vị ngọt; sự ngọt bùi, đồ ngọt	sweet
phồng, sưng lên	swell
sự sưng lên, sự phồng ra	swelling
sưng phồng, phình căng	swollen
bơi lội	swim
sự bơi lội	swimming
bể nước	swimming
sự đu đưa, lúc lắc; đánh đu, đu đưa, lúc lắc	swing
công tắc, roi; tắt, bật, đánh bằng gậy, roi	switch
/swel/ phồng lên, sưng lên	swollen
biểu tượng, ký hiệu	symbol
đồng cảm, đáng mến, dễ thương	sympathetic
sự đồng cảm, sự đồng ý	sympathy
hệ thống, chế độ	system
cái bàn	table
tấm, bản, thẻ phiến	tablet
or /'teikl/ giải quyết, khắc phục, bàn thảo; đồ dùng, dụng cụ	tackle
đuôi, đoạn cuối	tail
sự cầm nắm, sự lấy	take
nói chuyện, trò chuyện; cuộc trò chuyện, cuộc thảo luận	talk
cao	tall
thùng, két, bể	tank
mở vòi, đóng vồi; vòi, khóa	tap
băng, băng ghi âm; dải, dây	tape
bia, mục tiêu, đích	target
nhiệm vụ, nghĩa vụ, bài tập, công tác, công việc	task
vị, vị giác; nếm	taste
thuế; đánh thuế	tax
xe tắc xi	taxi
cây chè, trà, chè	tea
dạy	teach
sự dạy, công việc dạy học	teaching
giáo viên	teacher
đội, nhóm	team
xé, làm rắch; chỗ rách, miếng xe; nước mắt	tear
(thuộc) kỹ thuật, chuyên môn	technical
kỹ sảo, kỹ thuật, phương pháp kỹ thuật	technique
kỹ thuật học, công nghệ học	technology
máy điện thoại, gọi điện thoại	telephone
vô tuyến truyền hình	television
nói, nói với	tell
nhiệt độ	temperature
tạm thời, nhất thời	temporary
tạm	temporarily
trông nom, chăm sóc, giữ gìn, hầu hạ	tend
xu hướng, chiều hướng, khuynh hướng	tendency
sự căng, độ căng, tình trạng căng	tension
lều, rạp	tent
giới hạn, kỳ hạn, khóa, kỳ học	term
khủng khiếp, ghê sợ	terrible
tồi tệ, không chịu nổi	terribly
bài kiểm tra, sự thử nghiệm, xét nghiệm; kiểm tra, xét nghiệm, thử nghiệm	test
nguyên văn, bản văn, chủ đề, đề tì	text
hơn	than
cám ơn	thank
sự cảm ơn, lời cảm ơn	thanks
cảm ơn bạn (ông bà, anh chị...)	thank
người ấy, đó, vật ấy, đó; rằng, là	that
cái, con, người, ấy này....	the
rạp hát, nhà hát	theatre
của chúng, của chúng nó, của họ	their
của chúng, của chúng nó, của họ	theirs
chúng, chúng nó, họ	them
đề tài, chủ đề	theme
tự chúng, tự họ, tự	themselves
khi đó, lúc đó, tiếp đó	then
lý thuyết, học thuyết	theory
ở nơi đó, tại nơi đó	there
bởi vậy, cho nên, vì thế	therefore
chúng, chúng nó, họ; những cái ấy	they
dày; đậm	thick
dày; dày đặc; thành lớp dày	thickly
tính chất dày, độ dày, bề dày	thickness
kẻ trộm, kẻ cắp	thief
mỏng, mảnh	thin
cái, đồ, vật	thing
nghĩ, suy nghĩ	think
sự suy nghĩ, ý nghĩ	thinking
khát, cảm thấy khát	thirsty
cái này, điều này, việc này	this
cẩn thận, kỹ lưỡng	thorough
kỹ lưỡng, thấu đáo, triệt để	thoroughly
dù, dù cho, mặc dù; mặc dù, tuy nhiên, tuy vậy	though
sự suy nghĩ, khả năng suy nghĩ; ý nghĩ, tư tưởng, tư duy	thought
chỉ, sợi chỉ, sợi dây	thread
sự đe dọa, lời đe dọa	threat
dọa, đe dọa	threaten
sự đe dọa, sự hăm dọa	threatening
cổ, cổ họng	throat
qua, xuyên qua	through
khắp, suốt	throughout
ném, vứt, quăng	throw
ngón tay cái	thumb
thứ 5	Thursday
như vậy, như thế, do đó	thus
vé	ticket
sạch sẽ, ngăn nắp, gọn gàng; làm cho sạch sẽ, gọn gàng, ngăn nắp	tidy
không gọn gàng, không ngăn nắp, lộn xộn	untidy
buộc, cột, trói; dây buộc, daay trói, dây giày	tie
kín, chặt, chật	tight
chặc chẽ, sít sao	tightly
cho đến khi, tới lúc mà	till
thời gian, thì giờ	time
kế hoạch làm việc, thời gian biểu	timetable
thiếc	tin
rất nhỏ, nhỏ xíu	tiny
đầu, mút, đỉnh, chóp; bịt đầu, lắp đầu vào	tip
) /´taiə/ làm mệt mỏi, trở nên mệt nhọc; lốp, vỏ xe	tire
sự mệt mỏi, sự mệt nhọc	tiring
mệt, muốn ngủ, nhàm chán	tired
đầu đề, tiêu đề; tước vị, tư cách	title
theo hướng, tới	to
vào ngày này; hôm nay, ngày nay	today
ngón chân (người)	toe
cùng nhau, cùng với	together
nhà vệ sinh; sự trang điểm (rửa mặt, ăn mặc, chải tóc...)	toilet
cà chua	tomato
vào ngày mai; ngày mai	tomorrow
tấn	ton
tiếng, giọng	tone
lưỡi	tongue
vào đêm nay, vào tối nay; đêm nay, tối nay	tonight
tấn	tonne
cũng	too
dụng cụ, đồ dùng	tool
răng	tooth
chóp, đỉnh; đứng đầu, trên hết	top
đề tài, chủ đề	topic
tổng cộng, toàn bộ; tổng số, toàn bộ số lượng	total
hoàn toàn	totally
sờ, mó, tiếp xúc; sự sờ, sự mó, sự tiếp xúc	touch
chắc, bền, dai	tough
cuộc đo du lịch, cuộc đi dạo, chuyến du lịch; đi du lịch	tour
khách du lịch	tourist
theo hướng, về hướng	towards
khăn tắm, khăn lau	towel
tháp	tower
thị trấn, thị xã, thành phố nhỏ	town
đồ chơi, đồ trang trí; thể loại đồ chơi	toy
phát hiện, tìm thấy, vạch, chỉ ra, phác họa; dấu, vết, một chút	trace
phần của đĩa; đường mòn, đường đua	track
thương mại, buôn bán; buôn bán, trao đổi	trade
sự kinh doanh, việc mua bán	trading
truyền thống	tradition
theo truyền thống, theo lối cổ	traditional
(thuộc) truyền thống, là truyền thống	traditionally
sự đi lại, sự giao thông, sự chuyển động	traffic
xe lửa, tàu hỏa; dạy, rèn luyện, đào tạo	train
sự dạy dỗ, sự huấn luyện, sự đào tạo	training
dời, di chuyển; sự di chuyển, sự dời chỗ	transfer
thay đổi, biến đổi	transform
dịch, biên dịch, phiên dịch	translate
sự dịch	translation
trong suốt; dễ hiểu, sáng sủa	transparent
sự vận chuyển, sự vận tải; phương tiện đi lại	transport
(BrE, NAmE) chuyên chở, vận tải	transport
đồ đạc, hành lý; bẫy, cạm bãy; bẫy, giữ, chặn lại	trap
đi lại, đi du lịch, di chuyển; sự đi, những chuyến đi	travel
người đi, lữ khách	traveller
đối xử, đối đãi, cư xử	treat
sự đối xử, sự cư xử	treatment
cây	tree
phương hướng, xu hướng, chiều hướng	trend
sự thử nghiệm, cuộc thử nghiệm	trial
hình tam giác	triangle
mưu mẹo, thủ đoạn, trò lừa gatj; lừa, lừa gạt	trick
cuộc dạo chơi, cuộc du ngoạn; đi dạo, du ngoạn	trip
nhiệt đới	tropical
điều lo lắng, điều muộn phiền	trouble
quần	trousers
rau quả tươi	truck
đúng, thật	true
đúng sự thật, đích thực, thực sự	truly
niềm tin, sự phó thác; tin, tin cậy, phó thác	trust
sự thật	truth
thử, cố gắng	try
ống, tuýp	tube
thứ 3	Tuesday
điệu, giai điệu; lên dây, so dây (đàn)	tune
đường hầm, hang	tunnel
quay, xoay, vặn; sự quay, vòng quay	turn
hai lần	twice
sinh đôi, tạo thành cặp; cặp song sinh	twin
xoắn, cuộn, quắn; sự xoắn, vòng xoắn	twist
được xoắn, được cuộn	twisted
loại, kiểu, mẫu; phân loại, xếp loại	type
tiêu biểu, điển hình, đặc trưng	typical
điển hình, tiêu biểu	typically
lốp, vỏ xe	tyre
xấu xí, xấu xa	ugly
cuối cùng, sau cùng	ultimate
cuối cùng, sau cùng	ultimately
ô, dù	umbrella
không thể, không có khẳ năng (# có thể)	unable
không thể chấp nhận	unacceptable
không chắc chắn, khôn biết rõ ràng	uncertain
chú, bác	uncle
bất tiện, không tiện lợi	uncomfortable
bất tỉnh, ngất đi	unconscious
không bị kiềm chế, không bị kiểm tra	uncontrolled
dưới, ở dưới; ở phía dưới, về phía dưới	under
dưới mặt đất, ngầm dưới đất; ngầm	underground
dưới, bên dưới	underneath
hiểu, nhận thức	understand
trí tuệ, sự hiểu biết	understanding
ở dưới mặt nước, dưới mặt nước	underwater
quần lót	underwear
tháo, gỡ, xóa, hủy bỏ	undo
không dùng, thất nghiệp	unemployed
sự thất nghiệp, tình trạng thất nghiệp	unemployment
bất ngờ, đột ngột, gây ngạc nhiên	unexpected,
không đúng, không công bằng, gian lận	unfair,
không may, rủi ro, bất hạnh	unfortunate
một cách đáng tiếc, một cách không may	unfortunately
đối địch, không thân thiện	unfriendly
sự buồn, nỗi buồn	unhappiness
buồn rầu, khổ sở	unhappy
đồng phục; đều, giống nhau, đồng dạng	uniform
không quan trọng	unimportant
liên hiệp, sự đoàn kết, sự hiệp nhất	union
độc nhất vô nhị	unique
đơn vị	unit
liên kết, hợp nhất, hợp lại, kết thân	unite
liên minh, đoàn kết, chung, thống nhất	united
vũ trụ	universe
trường đại học	university
không tử tế, không tốt	unkind
không biết, không được nhận ra	unknown
trừ phi, trừ khi, nếu không	unless
không giống, khác	unlike
không có thể xảy ra, không chắc chắn; không có thực	unlikely
tháo, dỡ	unload
không gặp may, không may mắn	unlucky
không cần thiết, không mong muốn	unnecessary
không dễ chịu, khó chịu	unpleasant
vô lý, vượt quá giới hạn của cái hợp lý	unreasonable
không đúng mực, không vững, không chắc	unsteady
không thành công, không thành đạt	unsuccessful
không gọn gàng, không ngăn nắp, lộn xộn	untidy
trước khi, cho đến khi	until
hiếm, khác thường	unusual,
không muốn, không có ý định	unwilling,
ở trên, lên trên, lên	up
trên, ở trên	upon
cao hơn	upper
làm đổ, đánh đổ	upset
tính đánh đổ, làm đổ	upsetting
lộn ngược	upside
ở tên gác, cư ngụ ở tầng gác; tầng trên, gác	upstairs
lên, hướng lên, đi lên	upward
(thuộc) thành phố, khu vực	urban
thúc, giục, giục giã; sự thúc đẩy, sự thôi thúc	urge
gấp, khẩn cấp	urgent
chúng tôi, chúng ta; tôi và anh	us
sử dụng, dùng; sự dùng, sự sử dụng	use
đã dùng, đã sử dụng	used
to doing sth sử dụng cái gì, sử dụng để làm cái gì	used
đã quen dùng	used
hữu ích, giúp ích	useful
vô ích, vô dụng	useless
người dùng, người sử dụng	user
thông thường, thường dùng	usual
thường thường	usually
hiếm, khác thường, đáng chú ý	unusual
cực kỳ, khác thường	unusually
kỳ nghỉ hè, kỳ nghỉ lễ; ngày nghỉ, ngày lễ	vacation
chắc chắn, hiệu quả, hợp lý	valid
thung lũng	valley
có giá trị lớn, đáng giá	valuable
giá trị, ước tính, định giá	value
tiền đội, quân tiên phong; xe tải	van
sự biến đổi, sự thay đổi mức độ, sự khác nhau	variation
sự đa dạng, trạng thái khác nhau	variety
khác nhau, thuộc về nhiều loại	various
thay đổi, làm cho khác nhau, biến đổi	vary
thuộc nhiều loại khác nhau, những vẻ đa dạng	varied
rộng lớn, mênh mông	vast
rau, thực vật	vegetable
xe cộ	vehicle
sự án kinh doanh, công việc kinh doanh; liều, mạo hiểm, cả gan	venture
bản dịch sang một ngôn ngữ khác	version
thẳng đứng, đứng	vertical
rất, lắm	very
qua, theo đường	via
nạn nhân	victim
chiến thắng	victory
video	video
sự nhìn, tầm nhìn; nhìn thấy, xem, quan sát	view
làng, xã	village
sự ác liệt, sự dữ dội; bạo lực	violence
mãnh liệt, mạnh mẽ, hung dữ	violent
mãnh liệt, dữ dội	violently
thực sự, hầu như, gần như	virtually
vi rút	virus
hữu hình, thấy được	visible
sự nhìn, thị lực	vision
đi thăm hỏi, đến chơi, tham quan; sự đi thăm, sự thăm viếng	visit
khách, du khách	visitor
(thuộc) sự sống, cần cho sự sống	vital
từ vựng	vocabulary
tiếng, giọng nói	voice
thế tích, quyển, tập	volume
sự bỏ phiếu, sự bầu cử; bỏ phiếu, bầu cử	vote
tiền lương, tiền công	wage
eo, chỗ thắt lưng	waist
chờ đợi	wait
người hầu bàn, người đợi, người trông chờ	waiter,
thức dậy, tỉnh thức	wake
đi, đi bộ; sự đi bộ, sự đi dạo	walk
sự đi, sự đi bộ	walking
tường, vách	wall
cái ví	wallet
đi lang thang; sự đi lang thang	wander
muốn	want
chiến tranh	war
ấm, ấm áp; làm cho nóng, hâm nóng	warm
trạng thái ấm, sự ấm áp; hơi ấm	warmth
báo cho biết, cảnh báo	warn
sự báo trước, lời cảnh báo	warning
rửa, giặt	wash
sự tắm rửa, sự giặt	washing
lãng phí, uổng phí; vùng hoang vu, sa mạc; bỏ hoang	waste
nhìn, theo dõi, quan sát; sự canh gác, sự canh phòng	watch
nước	water
sóng, gợn nước; gợn sóng, uốn thành sóng	wave
đường, đường đi	way
chúng tôi, chúng ta	we
yếu, yếu ớt	weak
tình trạng yếu đuối, yếu ớt	weakness
sự giàu có, sự giàu sang	wealth
vũ khí	weapon
mặc, mang, đeo	wear
thời tiết	weather
mạng, lưới	web
không gian liên tới với Internet	website
lễ cưới, hôn lễ	wedding
thứ 4	Wednesday
tuần, tuần lễ	week
cuối tuần	weekend
mỗi tuần một lần, hàng tuần	weekly
cân, cân nặng	weigh
trọng lượng	weight
chào mừng, hoan nghênh	welcome
tốt, giỏi; ôi, may quá!	well
phía Tây, theo phía tây, về hướng tây	west
về phía tây, của phía tây	western
ướt, ẩm ướt	wet
gì, thế nào	what
bất cứ thứ gì, bất kể thứ gì	whatever
bánh xe	wheel
khi, lúc, vào lúc nào	when
bất cứ lúc nào, lúc nào	whenever
đâu, ở đâu; nơi mà	where
nhưng ngược lại, trong khi	whereas
ở bất cứ nơi nào, ở bất cứ nơi đâu	wherever
có..không; có... chăng; không biết có.. không	whether
nào, bất cứ.. nào; ấy, đó	which
trong lúc, trong khi; lúc, chốc, lát	while
trong lúc, trong khi	whilst
nói thì thầm, xì xào; tiếng nói thì thầm, tiếng xì xào	whisper
sự huýt sáo, sự thổi còi; huýt sáo, thổi còi	whistle
trắng; màu trắng	white
ai, người nào, kẻ nào, người như thế nào	who
ai, người nào, bất cứ ai, bất cứ người nào, dù ai	whoever
bình an vô sự, không suy suyển, không hư hỏng; toàn bộ, tất cả, toàn thể	whole
ai, người nào; người mà	whom
của ai	whose
tại sao, vì sao	why
rộng, rộng lớn	wide
nhiều, xa; rộng rãi	widely
tính chất rộng, bề rộng	width
vợ	wife
dại, hoang	wild
dại, hoang	wildly
sẽ; ý chí, ý định	will
bằng lòng, vui lòng, muốn	willing
sẵn lòng, tự nguyện	willingly
không sẵn lòng, miễn cưỡng	unwilling
không sẵn lòng, miễn cưỡng	unwillingly
sự bằng lòng, sự vui lòng	willingness
chiếm, đọat, thu được	win
đang dành thắng lợi, thắng cuộc	winning
quấn lại, cuộn lại	wind
gió	wind
cửa sổ	window
rượu, đồ uống	wine
cánh, sự bay, sự cất cánh	wing
người thắng cuộc	winner
mùa đông	winter
dây (kim loại)	wire
khôn ngoan, sáng suốt, thông thái	wise
ước, mong muốn; sự mong ước, lòng mong muốn	wish
với, cùng	with
rút, rút khỏi, rút lui	withdraw
trong vong thời gian, trong khoảng thời gian	within
không, không có	without
sự làm chứng, bằng chứng; chứng kiến, làm chứng	witness
đàn bà, phụ nữ	woman
ngạc nhiên, lấy làm lạ, kinh ngạc	wonder
phi thường, khác thường, kỳ diệu, tuyệt vời	wonderful
gỗ	wood
làm bằng gỗ	wooden
len	wool
từ	word
làm việc, sự làm việc	work
sự làm, sự làm việc	working
người lao động	worker
thế giới	world
lo lắng, suy nghĩ; sự lo lắng, suy nghĩ	worry
gấy lo lắng, gây lo nghĩ	worrying
bồn chồn, lo nghĩ, tỏ ra lo lắng	worried
sự tôn thờ, sự tôn sùng; thờ, thờ phụng, tôn thờ	worship
đáng giá, có giá trị	worth
	would
vết thương, thương tích; làm bị thường, gây thương tích	wound
bị thương	wounded
gói, bọc, quấn	wrap
vật bao bọc, vật quấn quanh	wrapping
cổ tay	wrist
viết	write
sự viết	writing
viết ra, được thảo ra	written
người viết	writer
sai	wrong
một cách bất công, không đúng	wrongly
lat, thước Anh (bằng 0, 914 mét)	yard
há miệng; cử chỉ ngáp	yawn
vâng, ừ	yeah
năm	year
vàng; màu vàng	yellow
vâng, phải, có chứ	yes
hôm qua	yesterday
còn, hãy cỏn, còn nữa; như mà, xong, tuy thế, tuy nhiên	yet
anh, chị, ông, bà, ngài, ngươi, mày; các anh, các chị, các ông, các bà, các ngài, các người, chúng mày	you
trẻ, trẻ tuổi, thanh niên	young
của anh, của chị, của ngài, của mày; của các anh, của các chị, của các ngài, của chúng mày	your
cái của anh, cái của chị, cái của ngài, cái của mày; cái của các anh, cái của các chị, cái của các ngài, cái của chúng mày	yours
tự anh, tự chị, chính anh, chính mày, tự mày, tự mình	yourself
tuổi trẻ, tuổi xuân, tuổi thanh niên, tuổi niên thiếu	youth
số không	zero
khu vực, miền, vùng	zone
